"Area","GP led service","Hospital Hub","Pharmacies","Vaccination centre","Total"
"Adur",2,0,0,0,2
"Arun",3,0,0,0,3
"Chichester",3,1,1,1,6
"Crawley",4,1,0,1,6
"Horsham",5,0,0,0,5
"Mid Sussex",2,2,0,0,4
"Worthing",3,1,0,0,4
"West Sussex",22,5,1,2,30
"Brighton and Hove",1,2,1,1,5
"Eastbourne",3,1,0,1,5
"Hastings",1,1,1,0,3
"Lewes",1,0,0,0,1
"Rother",2,0,2,0,4
"Wealden",2,2,0,0,4
"East Sussex",9,4,3,1,17
