"Area","GP led service","Hospital Hub","Pharmacies","Vaccination centre","Total"
"Adur",2,2,0,0,4
"Arun",2,3,0,0,5
"Chichester",1,5,1,2,9
"Crawley",4,8,0,1,13
"Horsham",5,5,0,0,10
"Mid Sussex",2,3,0,0,5
"Worthing",3,5,0,0,8
"West Sussex",19,31,1,3,54
"Brighton and Hove",1,5,1,1,8
"Eastbourne",3,4,0,0,7
"Hastings",1,3,1,0,5
"Lewes",1,2,0,0,3
"Rother",1,3,2,0,6
"Wealden",2,3,0,0,5
"East Sussex",8,15,3,0,26
