msoa11cd,msoa11nm,Age_12_15,Age_16_17,Age_18_24,Age_25_29,Age_30_34,Age_35_39,Age_40_44,Age_45_49,Age_50_54,Age_55_59,Age_60_64,Age_65_69,Age_70_74,Age_75_79,Age_80_and_over,Age_18_and_over,Age_16_and_over,Age_12_and_over
E02002796,Allestree North,343,161,393,257,280,376,396,459,451,516,408,396,442,352,456,5182,5343,5686
E02002797,Allestree South,313,157,470,337,354,458,464,438,548,548,501,439,542,466,865,6430,6587,6900
E02002798,Oakwood,414,206,813,821,745,669,631,693,832,906,785,581,544,331,370,8721,8927,9341
E02002799,Breadsall Hilltop,374,171,563,497,608,525,458,422,452,424,329,221,215,174,234,5122,5293,5667
E02002800,Darley Abbey,328,141,556,399,387,506,538,507,505,528,423,354,402,310,544,5959,6100,6428
E02002801,Chaddesden North,422,167,601,522,597,535,443,466,577,574,456,354,380,339,460,6304,6471,6893
E02002802,Chaddesden West,558,260,748,649,735,679,602,499,588,570,443,315,270,199,255,6552,6812,7370
E02002803,Little Chester,208,97,2719,1121,882,705,586,523,442,444,309,305,248,154,198,8636,8733,8941
E02002804,Mackworth,514,242,696,644,750,751,615,494,594,613,498,383,392,246,402,7078,7320,7834
E02002805,Spondon North,236,116,339,268,296,332,317,363,423,436,413,348,423,406,495,4859,4975,5211
E02002806,New Zealand,190,112,1388,898,719,557,453,418,362,319,263,187,157,93,123,5937,6049,6239
E02002807,Chaddesden Park,493,222,749,609,640,633,564,606,720,661,485,448,509,355,445,7424,7646,8139
E02002808,Cathedral Quarter & California,410,178,2587,2077,1814,1506,1109,905,767,656,489,313,231,158,239,12851,13029,13439
E02002809,Spondon South,378,149,552,490,544,480,438,478,505,514,404,334,367,320,463,5889,6038,6416
E02002810,Mickleover North,404,185,577,537,635,640,595,606,603,622,577,549,567,432,594,7534,7719,8123
E02002811,New Normanton,802,391,1431,1327,1326,1257,1129,968,845,660,525,393,215,137,238,10451,10842,11644
E02002812,Littleover East,413,180,699,667,620,573,553,540,595,545,437,412,372,305,478,6796,6976,7389
E02002813,Rose Hill & Castleward,892,402,1459,1254,1448,1423,1158,1066,824,630,500,368,221,169,337,10857,11259,12151
E02002814,Mickleover South,318,151,449,380,395,461,464,452,534,558,562,572,589,384,661,6461,6612,6930
E02002815,Normanton North & Peartree,745,348,1160,848,936,951,883,752,637,458,344,254,176,124,223,7746,8094,8839
E02002816,Littleover West & Heatherton,645,297,885,513,592,675,778,834,848,669,527,475,422,286,321,7825,8122,8767
E02002817,Normanton West,326,178,491,334,393,455,448,431,445,450,367,383,374,267,420,5258,5436,5762
E02002818,Normanton South,621,283,862,673,740,797,735,613,539,472,362,314,245,186,343,6881,7164,7785
E02002819,Wilmorton & Alvaston Village,289,144,568,630,653,615,519,489,527,579,482,369,351,248,352,6382,6526,6815
E02002820,Alvaston & Crewton,547,232,783,794,972,855,730,667,695,693,534,401,356,246,292,8018,8250,8797
E02002821,Allenton & Osmaston,895,408,1200,931,1122,1125,1037,823,833,760,534,384,291,212,303,9555,9963,10858
E02002822,Sunny Hill,358,181,606,452,475,493,491,476,486,474,414,327,296,245,423,5658,5839,6197
E02002823,Boulton,372,187,581,487,537,481,421,442,545,594,457,400,417,390,450,6202,6389,6761
E02002824,Sinfin,703,312,952,729,877,904,815,756,675,633,533,535,447,299,308,8463,8775,9478
E02002825,Chellaston West & Shelton Lock,504,239,583,454,508,608,636,641,679,549,492,433,505,345,530,6963,7202,7706
E02002826,Chellaston East,399,194,590,448,468,476,515,531,583,548,461,318,299,207,279,5723,5917,6316
E02002827,Beaumont Park,390,182,573,453,577,625,535,451,508,467,410,305,240,155,132,5431,5613,6003
E02002828,Rushey Mead North,440,185,650,547,577,774,649,607,545,539,579,581,443,300,362,7153,7338,7778
E02002829,Stocking Farm & Mowmacre,817,368,1123,902,1012,1054,927,836,825,667,636,425,365,218,367,9357,9725,10542
E02002830,Bradgate Heights & Beaumont Leys,771,346,1029,879,985,1050,908,819,731,605,523,433,372,183,196,8713,9059,9830
E02002831,Rushey Mead South,443,224,710,520,549,603,627,556,508,511,484,426,339,210,349,6392,6616,7059
E02002832,Belgrave North West,606,280,1069,899,873,1005,919,840,770,638,739,583,491,267,431,9524,9804,10410
E02002833,Belgrave North East,534,277,953,836,807,844,777,711,678,641,596,530,345,193,251,8162,8439,8973
E02002834,Abbey Park,590,251,1285,1223,1232,1146,996,790,770,690,611,494,472,335,422,10466,10717,11307
E02002835,Hamilton & Humberstone,1002,453,1425,1120,1265,1403,1388,1064,946,831,718,616,416,260,331,11783,12236,13238
E02002836,Belgrave South,522,269,1140,967,927,962,913,871,915,753,763,611,492,272,395,9981,10250,10772
E02002837,Northfields & Merrydale,711,388,1246,779,844,906,869,790,675,573,464,342,210,147,165,8010,8398,9109
E02002838,New Parks & Stokeswood,683,312,927,559,702,667,668,548,596,517,391,308,294,200,244,6621,6933,7616
E02002839,Colchester Road,532,258,737,542,640,711,654,563,580,534,488,418,345,255,362,6829,7087,7619
E02002842,Newfoundpool,392,173,987,1023,1108,1036,796,636,522,457,332,205,150,88,93,7433,7606,7998
E02002843,Spinney Hill Road,1004,480,1930,1354,1366,1428,1379,1284,1058,888,799,668,430,247,309,13140,13620,14624
E02002844,St Matthews & Highfields North,1009,422,1344,942,997,1125,1110,1050,862,662,588,473,342,210,302,10007,10429,11438
E02002845,North Evington & Rowlatts Hill,748,357,1209,927,974,1023,945,861,807,723,615,478,400,238,367,9567,9924,10672
E02002846,Dane Hills & Western Park,358,159,528,489,526,590,586,527,615,568,499,381,353,272,342,6276,6435,6793
E02002847,Crown Hills,749,374,1423,1016,993,996,927,908,782,624,624,498,303,206,310,9610,9984,10733
E02002848,Highfields South,840,407,1816,1218,1157,1187,1067,927,754,586,532,426,337,184,250,10441,10848,11688
E02002849,West End & Westcotes,372,214,3122,2103,1902,1616,1103,859,754,586,459,342,229,159,275,13509,13723,14095
E02002851,Evington,485,259,809,536,613,675,578,565,520,582,598,556,426,333,576,7367,7626,8111
E02002852,Braunstone Park West,712,296,827,492,571,668,561,505,499,461,409,226,216,120,136,5691,5987,6699
E02002853,Stoneygate North,935,421,2007,1463,1363,1205,1187,996,935,791,672,636,415,260,422,12352,12773,13708
E02002854,Braunstone Park East,558,262,852,630,783,801,735,598,605,594,439,323,245,191,282,7078,7340,7898
E02002855,Rowley Fields & Faircharm,315,117,933,1054,1088,873,685,576,480,427,343,253,206,136,181,7235,7352,7667
E02002856,Clarendon Park & Stoneygate South,368,180,2125,1581,1194,1076,893,719,709,679,533,468,387,298,471,11133,11313,11681
E02002857,Aylestone North & Saffron Fields,356,152,652,727,849,725,572,514,460,399,326,240,173,132,143,5912,6064,6420
E02002858,Knighton,353,185,525,393,416,478,524,539,634,551,492,418,390,290,458,6108,6293,6646
E02002860,Aylestone South,412,203,628,578,623,584,613,583,565,596,529,425,435,307,457,6923,7126,7538
E02002861,Saffron Lane,649,339,908,618,629,749,622,549,546,524,401,306,226,147,204,6429,6768,7417
E02002862,Eyres Monsell,550,270,721,612,688,726,597,569,596,539,508,345,338,212,336,6787,7057,7607
E02006815,Thurnby Lodge,801,338,934,773,937,956,818,676,709,691,607,488,429,284,521,8823,9161,9962
E02006817,West Knighton,438,183,1804,1158,831,743,672,579,592,475,458,345,269,194,317,8437,8620,9058
E02006819,Kirby Frith,670,299,823,616,741,758,606,599,628,504,393,313,257,161,215,6614,6913,7583
E02006850,Leicester City South,196,107,5596,3139,1702,1115,787,533,397,304,223,132,105,67,89,14189,14296,14492
E02006851,Leicester City Centre,103,56,4269,2185,1253,815,501,263,265,177,135,92,63,23,28,10069,10125,10228
E02002863,"Market Overton, Cottesmore & Empingham",302,133,908,867,829,750,661,482,542,539,485,424,505,379,376,7747,7880,8182
E02002864,"Oakham West, Langham & Whissendine",379,207,497,395,512,550,520,560,586,582,515,467,512,452,596,6744,6951,7330
E02002865,Oakham East,519,365,531,356,400,367,425,421,567,561,542,525,574,501,704,6474,6839,7358
E02002866,"Ketton, Ryhall & Luffenham",362,179,414,242,299,347,449,529,627,619,566,493,617,402,548,6152,6331,6693
E02002867,"Uppingham, Lyddington & Braunston",792,528,628,363,402,376,393,503,680,686,669,569,597,492,632,6990,7518,8310
E02002868,Rise Park & Top Valley West,273,144,420,380,426,398,358,392,416,457,368,323,416,339,363,5056,5200,5473
E02002869,Bulwell North,485,198,700,642,663,598,515,503,529,568,412,332,311,213,294,6280,6478,6963
E02002871,Highbury Vale,376,152,607,592,613,536,496,506,617,603,529,381,379,286,436,6581,6733,7109
E02002872,Bulwell West,555,245,787,660,753,720,575,653,675,627,484,410,413,293,249,7299,7544,8099
E02002873,Bestwood,671,280,791,806,1021,1001,812,697,644,572,477,303,245,159,285,7813,8093,8764
E02002874,North Sherwood,457,238,926,852,972,856,721,642,639,598,435,339,306,219,315,7820,8058,8515
E02002875,Basford Park Lane,538,207,758,709,859,772,610,590,604,633,456,345,249,202,275,7062,7269,7807
E02002876,Old Basford,385,175,928,630,712,615,566,557,641,625,477,337,321,259,303,6971,7146,7531
E02002877,Sherwood Vale,303,130,487,698,784,705,681,567,550,554,468,406,372,242,346,6860,6990,7293
E02002878,Broxtowe & Cinderhill,894,366,1030,692,834,822,749,702,647,533,361,235,179,137,132,7053,7419,8313
E02002879,New Basford,527,225,1048,831,1099,1014,898,686,647,601,471,297,233,196,205,8226,8451,8978
E02002880,Aspley,719,361,955,712,819,808,731,648,597,587,395,253,231,148,149,7033,7394,8113
E02002881,Bilborough North,431,207,601,558,609,581,471,437,496,467,377,242,233,172,268,5512,5719,6150
E02002882,Mapperley Park,329,168,1076,908,874,740,572,599,615,598,420,369,312,167,306,7556,7724,8053
E02002883,Thorneywood,389,182,658,720,782,769,622,553,602,550,451,302,265,175,178,6627,6809,7198
E02002884,Forest Fields,393,191,1071,841,905,802,665,499,446,362,250,194,134,81,155,6405,6596,6989
E02002885,Hyson Green,666,304,1741,1183,1338,1191,993,795,603,423,339,210,137,95,91,9139,9443,10109
E02002886,Bobbers Mill,718,302,1212,946,953,978,844,707,673,557,508,403,346,282,400,8809,9111,9829
E02002887,Beechdale,406,181,612,488,468,484,429,473,515,502,412,327,369,300,376,5755,5936,6342
E02002888,St Ann's East,448,216,774,704,842,800,728,644,539,482,402,294,220,140,188,6757,6973,7421
E02002889,"Arboretum, Forest & Trent University",134,77,6750,1389,898,556,371,291,285,240,219,137,102,46,71,11355,11432,11566
E02002890,St Ann's West,288,152,4521,1586,1312,939,632,473,514,494,387,248,207,141,181,11635,11787,12075
E02002891,Bakersfield,498,221,680,627,689,672,630,567,604,605,482,387,336,252,359,6890,7111,7609
E02002892,Bilborough South,427,213,639,508,529,479,426,420,484,503,401,269,275,189,276,5398,5611,6038
E02002893,Radford,507,238,7227,2779,2052,1596,884,696,565,441,369,265,172,110,134,17290,17528,18035
E02002894,Wollaton Park,420,198,612,495,580,642,572,573,492,476,431,390,366,235,407,6271,6469,6889
E02002895,The Park & Castle,107,73,3969,1250,904,592,469,316,364,325,252,178,187,113,139,9058,9131,9238
E02002896,Sneinton,602,292,1220,1205,1282,1172,992,771,672,588,404,315,246,149,166,9182,9474,10076
E02002897,Wollaton Vale,480,199,490,436,487,531,577,565,572,565,439,423,474,358,596,6513,6712,7192
E02002898,Lenton & Dunkirk,180,84,5655,1631,1196,766,427,282,224,240,189,170,122,91,153,11146,11230,11410
E02002899,"University Park, Lenton Abbey & Jubilee Campus",226,167,9006,1707,1265,795,416,346,310,271,254,202,182,146,209,15109,15276,15502
E02002901,Wilford & Silverdale,252,129,421,444,480,508,417,438,449,437,407,373,290,222,420,5306,5435,5687
E02002902,Clifton North,407,225,2194,688,765,689,505,466,555,578,533,433,311,203,402,8322,8547,8954
E02002903,Clifton West,332,124,476,443,504,470,400,372,356,387,441,392,293,210,447,5191,5315,5647
E02002904,Clifton South,377,163,575,477,593,497,396,403,485,432,404,308,231,159,316,5276,5439,5816
E02006834,Top Valley East,428,203,607,570,621,590,443,479,539,616,462,344,333,235,436,6275,6478,6906
E02006904,City Centre & Trent Bridge,162,159,4195,2189,1437,898,573,393,326,309,191,148,113,69,67,10908,11067,11229
E02006905,Meadows,433,178,991,898,938,816,641,520,489,470,366,279,211,152,188,6959,7137,7570
E02004029,Alfreton,324,125,541,512,586,542,453,456,558,586,464,432,381,261,340,6112,6237,6561
E02004030,"Crich, Holloway & Wingfield",245,120,306,257,290,289,322,373,514,592,514,502,516,394,429,5298,5418,5663
E02004031,Somercotes & Pye Bridge,401,183,666,576,581,548,481,529,573,532,448,360,378,248,266,6186,6369,6770
E02004032,Swanwick & Leabrooks,302,171,567,442,488,504,458,549,675,630,625,567,673,483,506,7167,7338,7640
E02004033,"Ripley East, Riddings & Ironville",314,159,616,617,585,522,472,637,739,735,564,554,513,394,475,7423,7582,7896
E02004034,Ripley West,230,119,372,338,339,360,357,411,597,528,491,528,581,478,443,5823,5942,6172
E02004035,"Ambergate, Heage & Idridgehay",221,141,366,275,284,284,327,408,541,612,564,497,490,432,446,5526,5667,5888
E02004036,Ripley South & Loscoe,474,231,745,652,740,653,619,686,770,785,678,536,678,502,501,8545,8776,9250
E02004037,Belper Far Laund,363,189,567,405,409,496,510,575,698,635,536,441,501,364,457,6594,6783,7146
E02004038,Belper Town,274,119,431,428,489,468,452,596,632,657,545,447,526,367,467,6505,6624,6898
E02004039,Openwoodgate & Holbrook,331,143,502,408,436,437,462,576,606,697,556,489,491,352,401,6413,6556,6887
E02004040,Heanor Gate & Aldercar,458,196,703,618,694,644,640,663,785,737,626,510,510,352,365,7847,8043,8501
E02004041,Heanor East & Langley Mill,338,164,555,510,493,476,464,538,588,528,414,391,422,325,341,6045,6209,6547
E02004043,Kilburn & Horsley,358,145,497,407,478,446,475,440,582,591,487,488,510,366,409,6176,6321,6679
E02004044,"Duffield, Quarndon & Kirk Langley",549,225,583,435,455,506,612,641,711,726,632,457,555,453,665,7431,7656,8205
E02006827,Heanor South & Shipley Park,389,173,664,575,651,520,449,500,631,595,504,400,434,285,370,6578,6751,7140
E02004045,Clowne & Barlborough,441,213,692,599,652,585,567,660,878,798,689,593,626,482,493,8314,8527,8968
E02004046,Whitwell & Elmton,299,109,441,345,383,404,322,400,545,539,480,400,433,311,360,5363,5472,5771
E02004047,Creswell & Hodthorpe,297,123,445,515,520,437,373,391,426,370,354,321,299,252,269,4972,5095,5392
E02004048,Bolsover North & Shuttlewood,356,118,524,536,548,557,439,467,579,589,398,403,371,262,301,5974,6092,6448
E02004049,Bolsover South & Glapwell,306,164,523,470,463,432,397,508,642,693,597,561,552,421,517,6776,6940,7246
E02004050,Shirebrook North,393,193,623,633,619,577,430,496,633,541,459,325,285,305,343,6269,6462,6855
E02004051,"Langwith, Shirebrook South & Pleasley",463,206,740,825,827,727,578,672,799,777,660,511,484,429,406,8435,8641,9104
E02004052,"Tibshelf, Newton & Hardwick Park",381,179,638,598,610,568,508,554,669,748,602,512,459,380,426,7272,7451,7832
E02004053,South Normanton West,429,200,630,511,582,536,464,509,674,551,531,394,362,332,302,6378,6578,7007
E02004054,South Normanton Broadmeadows & Pinxton,393,189,641,575,608,581,551,632,830,803,583,527,493,399,469,7692,7881,8274
E02004055,Old Whittington,308,128,476,430,477,388,398,436,546,578,511,427,403,347,406,5823,5951,6259
E02004056,Staveley & Norbriggs,489,224,733,587,537,507,521,486,604,554,479,405,352,267,310,6342,6566,7055
E02004057,"New Whittington, Hollingwood & Barrow Hill",368,156,575,583,607,535,503,536,616,560,474,392,317,235,232,6165,6321,6689
E02004058,Dunston,360,179,578,525,620,573,520,483,588,580,505,408,423,349,415,6567,6746,7106
E02004059,Brimington South & Tapton,275,116,470,423,455,427,370,448,585,622,578,459,484,377,501,6199,6315,6590
E02004060,Inkersall Green & Duckmanton,412,179,568,458,463,442,454,504,553,557,476,460,509,380,431,6255,6434,6846
E02004061,Newbold,295,150,547,531,478,512,457,487,608,598,516,424,401,311,459,6329,6479,6774
E02004062,Loundsley Green & Holme Hall,299,153,503,431,473,407,472,476,592,667,613,562,574,358,396,6524,6677,6976
E02004063,Ashgate & Brockwell,337,161,444,410,395,418,455,521,573,695,588,508,507,464,577,6555,6716,7053
E02004064,Central Chesterfield & Stonegravels,412,215,767,819,880,838,781,679,695,695,534,383,352,233,364,8020,8235,8647
E02004065,Brookside & Walton,318,176,433,332,396,407,429,507,624,705,639,650,717,545,667,7051,7227,7545
E02004066,Spital & Hasland,462,205,764,825,766,767,736,771,917,912,783,655,685,522,668,9771,9976,10438
E02004067,Boythorpe & Birdholme,301,133,504,420,431,419,418,395,492,496,444,359,356,250,306,5290,5423,5724
E02004068,"Hathersage, Bradwell & Tideswell",333,176,443,307,316,316,339,465,616,736,629,521,536,426,553,6203,6379,6712
E02004069,"Bakewell North, Baslow & Calver",243,138,371,197,240,281,331,380,500,602,577,528,579,473,569,5628,5766,6009
E02004070,"Bakewell South, Youlgreave and Taddington",234,127,359,252,272,238,282,385,488,507,518,512,515,408,577,5313,5440,5674
E02004071,Darley Dale & Stanton,207,105,339,220,265,207,277,346,386,415,432,351,399,317,377,4331,4436,4643
E02004072,Matlock North,389,204,558,410,449,505,589,660,785,740,710,670,766,596,757,8195,8399,8788
E02004073,"Matlock South, Cromford & Winster",379,184,550,456,476,472,479,588,753,782,708,667,698,504,572,7705,7889,8268
E02004074,Wirksworth,276,131,402,326,295,287,312,410,507,505,469,451,466,320,389,5139,5270,5546
E02004075,"Ashbourne North, Dovedale & Carsington",297,150,461,305,284,294,317,424,649,826,664,545,592,463,456,6280,6430,6727
E02004076,Ashbourne South,390,188,542,475,452,502,489,499,591,578,443,411,433,335,485,6235,6423,6813
E02004077,"Doveridge, Brailsford & Bradley",383,237,658,463,497,433,492,554,744,836,691,564,538,410,493,7373,7610,7993
E02004078,Cotmanhay,380,156,606,505,520,441,396,478,484,490,424,331,401,283,308,5667,5823,6203
E02004080,Ilkeston Town,416,190,774,777,784,710,604,639,763,712,562,487,444,338,507,8101,8291,8707
E02004081,"Breadsall, Little Eaton & Stanley Common",267,120,356,210,261,289,372,415,506,481,416,429,424,312,391,4862,4982,5249
E02004082,West Hallam,230,115,390,301,306,332,345,317,498,582,474,439,479,356,470,5289,5404,5634
E02004083,Hallam Fields & Greenwood Ave,390,216,626,636,661,556,545,555,655,561,479,346,379,314,313,6626,6842,7232
E02004084,Kirk Hallam,284,131,435,380,457,428,351,377,422,402,392,323,307,273,384,4931,5062,5346
E02004085,Sandiacre & Stanton,431,232,608,491,574,533,576,544,672,647,579,463,511,428,610,7236,7468,7899
E02004086,Borrowash & Ockbrook,344,175,479,369,453,460,456,538,575,611,516,445,449,397,481,6229,6404,6748
E02004087,Long Eaton North,368,157,532,542,669,553,534,520,620,602,446,371,382,255,360,6386,6543,6911
E02004088,Long Eaton West,335,175,528,382,448,434,492,559,624,668,511,486,491,399,421,6443,6618,6953
E02004089,Long Eaton Town,287,157,564,643,691,614,450,478,529,501,405,268,264,180,244,5831,5988,6275
E02004090,Breaston & Draycott,255,109,415,330,355,364,376,360,494,485,444,395,427,320,429,5194,5303,5558
E02004091,Long Eaton South,354,206,630,596,676,618,601,636,788,792,638,497,544,395,462,7873,8079,8433
E02004092,Sawley,459,215,646,578,653,654,582,622,782,691,591,499,526,456,515,7795,8010,8469
E02006828,Shipley,317,190,556,483,510,440,434,535,620,571,456,363,386,252,233,5839,6029,6346
E02004093,Hadfield East & Tintwistle,295,156,452,401,536,463,444,398,513,563,448,388,337,203,231,5377,5533,5828
E02004094,Hadfield West & Gamesley,418,180,560,478,551,520,442,420,544,537,461,307,348,244,273,5685,5865,6283
E02004095,Glossop,424,185,716,637,790,694,672,675,818,875,766,521,588,378,432,8562,8747,9171
E02004096,"Dinting, Simmondley & Charlesworth",479,215,630,471,556,593,641,623,802,883,757,659,663,528,536,8342,8557,9036
E02004097,New Mills West & Furness Vale,294,148,430,431,467,499,478,607,663,724,600,466,523,350,338,6576,6724,7018
E02004098,New Mills East & Hayfield,342,165,484,422,480,493,449,524,585,647,583,491,493,349,366,6366,6531,6873
E02004100,Whaley Bridge & Chinley,396,182,532,425,481,475,470,517,734,743,695,596,551,409,471,7099,7281,7677
E02004102,Buxton North,302,169,672,527,495,428,443,540,637,705,629,502,522,366,644,7110,7279,7581
E02004103,Buxton South & East,404,165,613,434,516,460,426,432,527,526,442,349,321,245,315,5606,5771,6175
E02004104,Buxton Burbage & Harpur Hill,376,167,556,393,435,404,448,515,660,616,558,459,443,344,392,6223,6390,6766
E02006872,Chapel-en-le-Frith & Hope Valley,538,281,825,690,782,734,709,747,1044,1081,1015,847,897,677,802,10850,11131,11669
E02004105,Killamarsh,393,172,708,647,647,617,525,520,739,742,762,616,594,385,379,7881,8053,8446
E02004106,Eckington West & Coal Aston,260,147,362,312,316,342,359,419,534,565,525,500,607,487,591,5919,6066,6326
E02004108,Dronfield Town & Unstone,349,193,537,413,412,437,477,495,648,614,466,380,409,412,560,6260,6453,6802
E02004109,Dronfield Woodhouse & Holmesfield,268,133,374,256,288,415,363,403,523,478,514,483,604,523,596,5820,5953,6221
E02004110,Dronfield South & Gosforth Lane,348,166,473,354,420,435,471,532,569,499,495,505,516,486,514,6269,6435,6783
E02004111,Arkwright Town & Temple Normanton,229,121,332,320,368,308,304,349,434,477,429,368,385,324,372,4770,4891,5120
E02004112,Wingerworth & Holymoorside,231,120,330,233,261,285,322,359,494,531,559,512,589,508,583,5566,5686,5917
E02004113,Grassmoor & Holmewood,463,214,743,814,797,653,586,596,690,692,610,531,479,376,441,8008,8222,8685
E02004114,Ashover & New Tupton,286,132,510,501,488,463,429,489,627,672,642,602,628,548,622,7221,7353,7639
E02004115,North Wingfield & Pilsley,342,140,585,565,476,483,510,561,693,768,692,594,530,437,458,7352,7492,7834
E02004116,Clay Cross,393,190,626,563,599,549,538,538,633,660,502,466,478,399,442,6993,7183,7576
E02004117,"Stonebroom, Shirland & Wessington",359,159,559,429,508,455,475,494,629,660,585,506,548,413,450,6711,6870,7229
E02006804,Eckington East & Renishaw,433,226,637,555,553,547,495,560,676,650,490,421,413,343,450,6790,7016,7449
E02004118,Hatton & Burnaston,375,176,621,558,566,544,506,543,684,660,544,421,382,276,358,6663,6839,7214
E02004119,Hilton & Etwall,684,338,880,752,758,865,887,932,945,805,634,499,465,411,471,9304,9642,10326
E02004120,"Willington North, Findern & Stenson Fields",493,220,741,831,956,919,806,692,741,732,611,640,549,340,364,8922,9142,9635
E02004121,Aston-on-Trent & Barrow-upon-Trent,450,216,637,614,744,619,553,609,758,778,596,478,462,394,511,7753,7969,8419
E02004122,Willington South & Repton,526,386,607,343,389,329,357,451,567,532,470,436,427,355,371,5634,6020,6546
E02004123,"Melbourne, Ticknall & Hartshorne",316,137,388,318,342,373,435,458,541,629,566,476,446,314,450,5736,5873,6189
E02004124,Swadlincote North,403,190,593,524,559,497,483,496,604,598,495,414,437,341,383,6424,6614,7017
E02004125,Swadlincote West,468,205,702,586,597,562,568,567,725,671,558,533,509,380,366,7324,7529,7997
E02004126,Swadlincote Central,341,171,504,540,553,488,467,474,555,567,499,496,481,314,375,6313,6484,6825
E02004128,"Castle Gresley, Overseal & Coton",470,244,719,641,729,741,679,771,1018,964,776,678,760,583,604,9663,9907,10377
E02006919,Swadlincote South,541,199,786,770,848,863,797,797,782,679,521,415,390,260,248,8156,8355,8896
E02006920,Swadlincote East,459,167,657,622,666,637,550,628,713,543,423,378,324,217,225,6583,6750,7209
E02005334,Leicester Forest East,290,146,391,390,426,416,423,402,433,403,366,284,238,215,297,4684,4830,5120
E02005335,Kirby Muxloe & Thurlaston,391,185,459,371,401,422,453,518,543,586,523,428,447,383,643,6177,6362,6753
E02005336,Thorpe Astley,397,176,508,464,644,676,568,526,510,457,372,287,208,165,240,5625,5801,6198
E02005337,Braunstone Town,505,218,723,656,749,769,710,643,665,645,641,538,461,384,554,8138,8356,8861
E02005338,Enderby & Glen Parva,505,261,765,759,964,862,704,729,846,825,663,540,573,397,563,9190,9451,9956
E02005339,Narborough,407,221,579,495,551,601,554,600,663,702,565,512,509,364,384,7079,7300,7707
E02005340,Blaby Village,401,201,615,507,664,537,550,559,651,607,619,484,512,482,579,7366,7567,7968
E02005341,Whetstone,374,175,652,456,552,523,464,537,620,586,458,334,367,260,318,6127,6302,6676
E02005342,"Cosby, Croft & Elmesthorpe",349,158,432,402,477,467,426,444,530,586,541,439,487,375,414,6020,6178,6527
E02005343,Countesthorpe & Kilby,418,173,552,435,473,465,523,532,595,554,522,482,547,417,442,6539,6712,7130
E02005344,"Stoney Stanton, Sapcote & Sharnford",371,197,515,516,632,635,564,550,674,646,541,507,582,463,499,7324,7521,7892
E02006820,Glenfield,510,241,734,580,661,743,701,655,750,805,743,619,775,509,740,9015,9256,9766
E02005345,Loughborough Dishley & Hathern,251,115,436,404,522,546,449,404,487,433,450,457,390,278,256,5512,5627,5878
E02005346,Loughborough Lemyngton & Hastings,527,283,1774,1478,1466,1200,1083,889,827,712,636,499,394,219,369,11546,11829,12356
E02005347,Loughborough Storer & Queen's Park,246,211,4047,1392,883,604,475,403,423,396,361,310,284,193,288,10059,10270,10516
E02005348,Loughborough Garendon,211,84,433,377,406,370,350,312,379,426,409,395,473,344,354,5028,5112,5323
E02005349,Shepshed West,323,154,525,538,547,555,523,478,541,552,450,461,475,377,394,6416,6570,6893
E02005350,Shepshed East,270,142,434,430,495,479,412,419,507,533,437,453,425,290,373,5687,5829,6099
E02005351,Loughborough - University,328,186,7481,1736,876,583,424,365,367,346,298,257,254,211,265,13463,13649,13977
E02005352,"Wymeswold, Rearsby & Cossington",361,175,533,270,291,386,343,444,558,547,489,412,400,293,332,5298,5473,5834
E02005353,Loughborough - Shelthorpe & Woodthorpe,608,287,1313,988,981,880,796,682,710,628,514,440,416,314,384,9046,9333,9941
E02005354,Loughborough - Outwoods,479,238,1013,515,593,692,688,682,755,673,650,585,522,455,713,8536,8774,9253
E02005355,Barrow upon Soar,360,162,427,412,440,483,502,525,588,544,508,427,492,350,375,6073,6235,6595
E02005356,Quorn & Mountsorrel Castle,328,177,437,360,356,450,489,578,636,610,531,403,495,375,513,6233,6410,6738
E02005357,Sileby,422,194,552,623,744,559,602,535,617,577,473,410,367,264,307,6630,6824,7246
E02005358,Mountsorrel & Rothley,563,292,790,732,972,852,756,815,921,929,709,605,523,472,579,9655,9947,10510
E02005359,East Goscote & Queniborough,376,149,507,440,528,525,487,464,551,542,475,420,503,363,423,6228,6377,6753
E02005360,"Thurcaston, Woodhouse & Bradgate",261,122,443,271,271,325,366,389,509,542,482,453,486,337,453,5327,5449,5710
E02005361,Syston West,246,122,458,473,473,392,380,461,540,491,450,409,347,261,341,5476,5598,5844
E02005362,Syston East,328,170,491,399,511,549,528,478,533,515,433,403,429,307,395,5971,6141,6469
E02005363,Birstall Wanlip & Riverside,395,208,596,511,673,707,590,556,604,595,530,432,487,371,631,7283,7491,7886
E02005364,Birstall Central,244,130,414,324,324,365,351,367,444,423,375,292,237,203,279,4398,4528,4772
E02005365,Thurmaston,474,238,689,607,710,732,658,613,650,731,716,632,570,435,565,8308,8546,9020
E02005366,Anstey,341,151,506,430,520,559,435,481,593,488,456,388,451,369,409,6085,6236,6577
E02005368,"Tilton, Billesdon & Great Easton",337,160,412,263,249,286,347,436,583,622,562,454,444,339,376,5373,5533,5870
E02005369,Kibworth & Great Glen,661,285,774,662,684,777,805,877,856,928,778,684,747,589,726,9887,10172,10833
E02005370,Broughton Astley,526,235,754,599,592,569,584,696,800,725,641,550,546,334,365,7755,7990,8516
E02005371,"Fleckney, Kilworth & Foxton",521,256,693,515,569,574,584,760,912,956,753,688,689,510,556,8759,9015,9536
E02005372,"Dunton Bassett, Claybrooke & Swinford",471,227,733,500,525,494,547,678,900,1032,823,658,672,492,555,8609,8836,9307
E02005373,"Market Harborough West, Great Bowden & Lubenham",553,269,719,710,835,827,940,944,979,899,784,705,783,590,615,10330,10599,11152
E02005374,Market Harborough Central,355,258,545,356,450,419,386,394,485,479,389,360,366,297,515,5441,5699,6054
E02005375,Market Harborough South & Little Bowden,480,198,599,533,576,646,666,701,763,673,552,455,524,454,654,7796,7994,8474
E02005376,Lutterworth,548,286,778,553,695,640,675,793,817,746,662,537,619,568,623,8706,8992,9540
E02006816,"Houghton, Thurby & Scraptoft",399,184,607,460,539,568,546,476,580,624,593,520,472,406,564,6955,7139,7538
E02005377,Markfield & Thornton,453,199,595,521,593,510,530,560,664,683,571,546,610,470,525,7378,7577,8030
E02005378,Groby East,257,103,348,278,314,368,365,359,411,414,334,363,305,235,335,4429,4532,4789
E02005379,Groby West & Ratby,272,128,401,327,366,379,370,374,442,485,424,372,433,313,358,5044,5172,5444
E02005380,"Market Bosworth, Barlestone & Sheepy Magna",384,189,543,389,437,457,472,587,742,731,684,668,689,488,561,7448,7637,8021
E02005381,Desford & Newbold Verdon,470,192,484,456,562,555,513,601,702,634,631,586,650,509,538,7421,7613,8083
E02005382,Earl Shilton,480,205,755,726,760,749,652,689,719,777,712,575,633,462,578,8787,8992,9472
E02005383,Barwell,447,215,653,596,676,661,625,594,711,649,602,536,567,417,435,7722,7937,8384
E02005384,"Stoke Golding, Higham & Fenny Drayton",351,182,519,338,392,432,393,492,696,665,563,435,444,372,449,6190,6372,6723
E02005385,Hinckley East,272,138,384,337,379,404,411,409,507,509,433,431,480,337,415,5436,5574,5846
E02005386,Hinckley Central,378,190,709,731,792,744,692,634,691,649,552,380,421,333,441,7769,7959,8337
E02005387,Hinckley West,433,211,659,674,857,795,690,672,748,699,598,503,511,369,309,8084,8295,8728
E02005388,Hinckley Clarendon Park,278,130,432,435,499,508,404,460,456,435,354,274,340,222,291,5110,5240,5518
E02005389,Burbage St Catherines,283,153,396,306,310,335,368,387,475,440,354,381,385,342,526,5005,5158,5441
E02005390,Burbage Sketchley & Stretton,433,204,560,525,653,660,666,713,768,757,723,653,710,515,556,8459,8663,9096
E02005391,"Bottesford, Harby & Croxton Kerrial",532,224,625,393,393,435,566,649,906,972,778,699,722,528,607,8273,8497,9029
E02005392,Melton Mowbray North,433,212,650,558,599,551,589,577,760,722,568,530,616,455,597,7772,7984,8417
E02005393,"Asfordby, Frisby & Old Dalby",291,127,450,386,451,428,404,453,637,714,536,495,531,336,407,6228,6355,6646
E02005394,Melton Mowbray West,502,223,625,622,679,682,646,610,574,647,565,527,550,387,462,7576,7799,8301
E02005395,Melton Mowbray South,341,177,574,526,616,554,579,527,678,739,661,563,540,412,531,7500,7677,8018
E02005396,"Waltham, Wymondham & Great Dalby",318,142,420,308,304,290,352,443,627,718,616,525,520,398,450,5971,6113,6431
E02005397,Castle Donington,411,205,625,546,652,585,597,678,772,759,634,539,547,451,436,7821,8026,8437
E02005398,Kegworth & Belton,242,107,858,383,397,382,407,405,507,496,425,403,399,303,347,5712,5819,6061
E02005399,Ashby de la Zouch North,442,199,515,475,525,634,561,587,568,549,466,404,483,330,316,6413,6612,7054
E02005400,Thringstone & Swannington,251,110,333,302,352,351,329,338,427,434,425,413,445,352,340,4841,4951,5202
E02005401,"Packington, Ravenstone & Coleorton",346,162,397,293,323,372,385,459,574,567,503,424,421,319,309,5346,5508,5854
E02005402,Ashby de la Zouch South,342,160,461,256,372,441,418,446,500,511,414,397,487,361,456,5520,5680,6022
E02005403,Whitwick,260,117,424,413,448,379,394,430,489,540,440,409,414,366,417,5563,5680,5940
E02005404,Donisthope & Blackfordby,442,192,611,513,583,509,500,580,790,686,608,466,469,325,379,7019,7211,7653
E02005405,Agar Nook,370,182,603,419,478,476,405,452,507,519,452,410,474,342,391,5928,6110,6480
E02005406,Coalville,385,176,685,680,654,657,545,587,594,557,409,343,286,224,301,6522,6698,7083
E02005407,Hugglescote & Bardon Hill,488,229,771,833,893,768,767,792,877,762,589,451,456,374,356,8689,8918,9406
E02005408,Measham & Appleby Magna,374,182,574,467,538,505,488,518,680,633,519,478,442,366,348,6556,6738,7112
E02005409,Ibstock & Ellistown,534,291,828,693,866,763,723,827,980,849,727,594,651,490,507,9498,9789,10323
E02005412,Oadby South & West,532,235,584,493,583,677,671,580,600,552,566,499,489,411,762,7467,7702,8234
E02005414,Wigston Town,433,202,670,553,601,548,552,488,578,563,486,412,410,303,582,6746,6948,7381
E02005415,South Wigston,361,185,597,580,648,607,546,511,604,540,465,387,356,310,472,6623,6808,7169
E02005416,Wigston Harcourt & Little Hill,396,196,592,476,551,559,491,552,616,694,639,589,702,534,589,7584,7780,8176
E02006818,Wigston North,412,193,584,454,567,559,598,544,603,633,561,433,416,389,633,6974,7167,7579
E02006911,Oadby North & East,784,398,2372,1192,954,1009,1066,995,1057,1069,1018,716,729,521,826,13524,13922,14706
E02005417,Leake & Butterwick,340,161,870,792,759,626,591,667,708,745,636,616,563,443,522,8538,8699,9039
E02005418,Fenside & Lister Way,741,305,1111,1036,1241,1182,1118,908,865,769,687,464,419,250,390,10440,10745,11486
E02005419,Boston Central & North,547,248,1097,1141,1279,1117,963,883,850,755,558,369,288,217,343,9860,10108,10655
E02005420,Skirbeck,508,236,723,664,761,774,696,642,623,589,510,436,469,334,479,7700,7936,8444
E02005422,"Swineshead, Bicker & Holland Fen",315,157,432,355,358,399,374,438,524,553,551,457,488,381,405,5715,5872,6187
E02005423,"Kirton, Frampton & Algarkirk",531,239,760,637,771,779,615,649,759,779,728,658,657,481,614,8887,9126,9657
E02006864,Fishtoft & Wyberton East,446,214,602,528,588,591,513,570,658,724,567,565,573,428,617,7524,7738,8184
E02006865,Wyberton West & Fen,407,169,598,549,676,626,588,532,563,605,524,496,518,438,575,7288,7457,7864
E02005424,"Holton-le-Clay, Binbrook & Tetney",442,215,586,492,568,504,469,608,813,949,904,777,891,704,694,8959,9174,9616
E02005425,"Marshchapel, Somercotes & Grimoldby",308,138,397,278,304,322,286,378,543,608,617,537,565,433,442,5710,5848,6156
E02005426,Louth North & East,543,244,728,619,718,628,570,665,750,751,635,610,640,567,701,8582,8826,9369
E02005427,Louth Central & South,313,129,482,400,420,350,401,446,551,550,509,491,510,403,495,6008,6137,6450
E02005428,Mablethorpe,305,175,502,382,395,360,379,410,615,828,848,827,849,643,666,7704,7879,8184
E02005429,Sutton-on-Sea,127,71,216,187,163,152,155,230,350,526,696,805,887,688,718,5773,5844,5971
E02005430,"Wragby, Roughton & Ludford",246,129,427,286,296,316,314,333,543,661,612,624,621,506,562,6101,6230,6476
E02005431,"Alford, Withern & Willoughby",368,193,532,432,410,418,372,450,667,782,788,787,786,608,686,7718,7911,8279
E02005432,Little Cawthorpe & South Wolds,292,142,404,296,364,320,358,419,629,795,757,740,713,551,572,6918,7060,7352
E02005433,Ingoldmells & Chapel St Leonards,226,107,372,295,312,281,296,329,533,653,769,722,857,613,567,6599,6706,6932
E02005434,Horncastle,366,154,506,377,455,398,343,439,577,590,540,498,537,498,597,6355,6509,6875
E02005435,Skegness North,338,143,478,450,443,449,416,426,560,660,664,588,723,527,510,6894,7037,7375
E02005436,Spilsby & Burgh le Marsh,369,157,457,395,431,395,405,453,635,658,613,696,675,543,669,7025,7182,7551
E02005437,Skegness Town,307,137,555,472,474,440,444,430,550,532,505,410,389,251,340,5792,5929,6236
E02005438,Skegness South,351,172,499,412,413,405,379,405,524,539,481,459,562,414,502,5994,6166,6517
E02005439,Coningsby & Woodhall Spa,510,192,1039,915,996,835,737,684,755,848,861,763,874,755,978,11040,11232,11742
E02005440,Wainfleet All Saints,236,139,408,238,248,222,279,324,483,492,502,458,446,312,412,4824,4963,5199
E02005441,"Mareham, Sibsey & New Leake",385,193,481,365,373,393,398,501,700,806,765,696,705,537,602,7322,7515,7900
E02005442,Ermine,373,170,553,539,566,496,419,381,439,458,368,270,237,181,240,5147,5317,5690
E02005443,Glebe Park,322,141,541,531,581,510,490,441,466,516,432,356,391,296,391,5942,6083,6405
E02005444,Cathedral & West Common,456,221,1733,1153,1188,1075,893,771,840,871,692,591,572,441,714,11534,11755,12211
E02005445,"Monks Road, St Giles & Greetwell",689,342,1723,1367,1303,1224,1051,848,812,727,568,431,352,216,235,10857,11199,11888
E02005446,Wharf & University,128,61,5596,1053,638,449,369,305,293,324,280,219,206,126,143,10001,10062,10190
E02005447,Pelham Bridge & South Common,307,134,1615,1103,1003,764,664,586,485,392,317,210,148,116,256,7659,7793,8100
E02005448,Birchwood West,418,197,578,559,636,606,507,430,487,450,404,310,310,205,260,5742,5939,6357
E02005449,Boultham & New Boultham,315,146,1965,926,687,571,487,489,503,531,371,335,322,231,326,7744,7890,8205
E02005450,Hartsholme & Birchwood East,322,159,561,508,568,523,483,488,617,624,611,549,585,443,541,7101,7260,7582
E02005451,Bracebridge North & Boultham Moor,441,188,1052,683,726,649,561,552,571,514,460,311,276,214,342,6911,7099,7540
E02005452,Bracebridge South & Swallow Beck,542,263,804,674,722,719,709,726,841,861,756,657,664,483,617,9233,9496,10038
E02005453,Washingborough & Branston,472,239,678,459,527,540,553,731,860,915,775,709,808,644,819,9018,9257,9729
E02005455,"Skellingthorpe, Witham & Bassingham",649,282,989,799,991,985,877,993,1165,1078,922,774,826,649,693,11741,12023,12672
E02005456,Bracebridge Heath & Waddington,499,196,956,1024,1172,1111,886,740,768,708,639,533,545,471,643,10196,10392,10891
E02005457,"Metheringham, Nocton & Potterhanworth",416,176,558,409,479,505,471,514,683,742,628,512,602,481,586,7170,7346,7762
E02005458,"Navenby, Harmston & Brant Broughton",301,138,429,273,308,278,365,420,550,622,542,434,551,425,554,5751,5889,6190
E02005459,Ruskington North & Billinghay,393,186,574,417,431,414,388,495,681,779,699,537,597,476,522,7010,7196,7589
E02005460,Ruskington West & Cranwell,235,137,681,628,614,583,511,457,473,433,351,322,291,248,267,5859,5996,6231
E02005461,"Ruskington South, Leasingham & Osbournby",272,135,401,270,250,238,294,364,562,616,564,479,559,463,570,5630,5765,6037
E02005462,Sleaford East,472,232,689,644,727,643,526,626,723,736,571,489,558,413,566,7911,8143,8615
E02005463,Sleaford West,575,290,713,555,627,617,615,701,848,739,561,455,500,382,424,7737,8027,8602
E02005464,Heckington,344,162,485,402,384,359,396,449,687,787,675,664,709,568,652,7217,7379,7723
E02006866,North Hykeham South,458,201,648,602,667,639,562,533,599,546,483,363,467,354,504,6967,7168,7626
E02006867,North Hykeham North,334,169,575,461,505,467,451,471,601,576,532,494,544,447,627,6751,6920,7254
E02005465,"Donington, Quadring & Gosberton",378,175,577,440,481,426,468,531,665,781,697,675,670,471,617,7499,7674,8052
E02005466,"Long Sutton West, Gedney & Holbeach Hurn",314,131,420,347,323,338,330,431,500,594,525,502,582,369,477,5738,5869,6183
E02005467,Holbeach,344,146,564,494,521,429,448,523,535,543,497,463,468,414,687,6586,6732,7076
E02005468,"Moulton, Weston & Whaplode",366,162,527,327,380,369,379,480,649,697,603,493,600,391,514,6409,6571,6937
E02005469,Pinchbeck & Deeping St Nicholas,366,184,550,451,520,530,461,549,632,672,556,470,534,380,420,6725,6909,7275
E02005470,Spalding North,555,264,1041,1171,1295,1194,1053,941,931,789,678,541,555,450,727,11366,11630,12185
E02005471,Spalding East,477,217,730,703,806,814,661,650,719,668,567,511,521,400,526,8276,8493,8970
E02005472,Long Sutton East & Sutton Bridge,461,178,644,540,597,574,547,554,737,825,718,654,751,641,801,8583,8761,9222
E02005473,Spalding South West,471,197,714,709,858,822,685,704,706,678,558,490,540,468,649,8581,8778,9249
E02005474,Fleet Hargate & Holbeach St Johns,283,114,447,331,342,338,337,451,571,698,582,565,580,418,471,6131,6245,6528
E02005475,Crowland & Cowbit,365,177,464,489,458,433,417,503,567,555,459,393,433,316,351,5838,6015,6380
E02005476,"Ancaster, Caythorpe & Claypole",374,186,498,323,345,380,384,506,644,721,637,502,496,425,464,6325,6511,6885
E02005477,"Long Bennington, Allington & Barrowby",439,202,510,336,346,405,465,588,779,805,729,660,879,633,675,7810,8012,8451
E02005478,Grantham North East,576,238,736,560,613,616,657,683,735,696,662,617,621,543,690,8429,8667,9243
E02005479,Grantham North West,438,241,682,646,693,677,652,662,726,760,635,593,594,462,554,8336,8577,9015
E02005480,Grantham South West,510,224,615,583,558,576,578,503,520,442,369,282,299,217,211,5753,5977,6487
E02005481,Grantham South East,606,269,998,1055,1146,1047,902,800,965,841,666,485,475,383,528,10291,10560,11166
E02005482,"Corby Glen, Ropsley & Grantham Outskirts",423,238,600,441,477,464,566,644,843,825,772,733,744,501,485,8095,8333,8756
E02005483,Morton & Billingborough,344,173,524,423,348,379,361,489,720,730,659,519,537,453,531,6673,6846,7190
E02005484,"Harlaxton, Colsterworth & South Witham",348,149,411,371,391,404,377,508,593,684,552,488,484,403,394,6060,6209,6557
E02005485,Bourne West,462,187,519,550,604,532,526,538,535,587,509,451,515,400,498,6764,6951,7413
E02005486,Bourne East,502,232,651,517,595,616,676,662,704,645,513,512,534,425,647,7697,7929,8431
E02005487,"Langtoft, Thurlby & Uffington",478,232,566,349,408,429,495,662,861,929,872,720,771,569,625,8256,8488,8966
E02005488,Market Deeping,334,147,416,357,369,419,445,423,489,510,525,507,480,355,446,5741,5888,6222
E02005489,Deeping St James & Frognall,355,151,490,337,404,398,464,502,563,538,504,510,493,339,362,5904,6055,6410
E02005490,Stamford North,462,209,622,552,635,685,696,672,764,667,552,478,540,446,553,7862,8071,8533
E02005491,"Stamford Central, West and South",525,262,687,590,720,763,772,791,847,905,807,611,686,623,806,9608,9870,10395
E02005492,"Caistor, Kelsey & Keelby",478,225,571,435,501,500,559,621,798,907,914,798,756,554,588,8502,8727,9205
E02005493,"Morton, Blyton & Scotter",453,255,701,536,521,555,580,652,812,871,783,622,707,545,610,8495,8750,9203
E02005494,Market Rasen & Brookenby,395,204,571,533,523,505,489,585,776,820,784,721,754,599,726,8386,8590,8985
E02005495,Gainsborough West,504,224,904,805,833,738,641,666,801,776,613,567,485,410,450,8689,8913,9417
E02005496,Hemswell & Spital,288,142,396,301,353,377,336,368,528,640,546,471,487,342,306,5451,5593,5881
E02005497,Gainsborough East,462,203,581,531,545,511,447,482,498,468,413,365,348,275,334,5798,6001,6463
E02005498,Torksey & Stow,234,132,371,331,346,349,357,408,576,689,631,648,695,555,595,6551,6683,6917
E02005499,Dunholme & Welton,467,252,624,382,458,504,493,538,705,651,615,558,546,436,496,7006,7258,7725
E02005500,Saxilby & Scampton,283,137,432,408,447,439,373,450,556,641,595,510,488,450,429,6218,6355,6638
E02005501,"Nettleham, Sudbrooke & Scothern",362,161,455,397,439,488,453,478,602,617,606,549,634,517,650,6885,7046,7408
E02005502,Cherry Willingham & Bardney,441,191,595,492,567,522,541,570,641,757,668,667,738,586,681,8025,8216,8657
E02005612,"Rowlett, Gretton & Cottingham",365,177,529,439,547,573,523,454,578,602,574,455,362,294,325,6255,6432,6797
E02005613,Corby North,505,215,716,712,829,816,724,582,759,734,625,436,391,282,350,7956,8171,8676
E02005614,Corby Village & Weldon,693,289,881,1023,1391,1303,1036,879,886,889,671,543,441,311,357,10611,10900,11593
E02005615,Corby Lodge Park,495,196,685,681,828,782,632,570,669,717,623,481,437,368,474,7947,8143,8638
E02005616,Corby Town,313,152,525,494,530,549,475,450,486,504,360,263,221,147,200,5204,5356,5669
E02005617,Corby Kingswood,689,293,1119,974,1160,1162,918,731,837,788,660,481,393,281,320,9824,10117,10806
E02006862,Great Oakley and Danesholme,347,169,488,436,535,557,438,416,473,512,532,412,352,231,245,5627,5796,6143
E02006863,Snatchill,893,357,941,822,1136,1385,1248,1054,883,627,455,334,230,142,139,9396,9753,10646
E02005619,"Clipston, Naseby & Yelvertoft",296,130,451,315,307,312,384,466,590,627,521,406,414,299,410,5502,5632,5928
E02005620,Broxworth & Spratton,512,233,670,489,500,499,525,596,729,716,629,538,501,383,381,7156,7389,7901
E02005621,Braunston & Crick,353,188,621,625,689,657,590,613,766,817,646,590,633,449,527,8223,8411,8764
E02005622,Long Buckby East & Ravensthorpe,497,232,658,497,524,544,618,727,844,844,728,628,592,460,485,8149,8381,8878
E02005623,Walgrave & Moulton,555,267,736,721,823,828,779,695,804,855,637,622,646,469,614,9229,9496,10051
E02005624,Daventry North,542,273,916,863,1038,942,847,812,929,848,643,468,472,338,344,9460,9733,10275
E02005625,Daventry Central,448,199,683,662,785,668,692,650,719,604,499,487,511,454,594,8008,8207,8655
E02005626,Daventry South & Southbrook,366,175,569,556,687,612,527,476,509,439,398,306,305,207,174,5765,5940,6306
E02005627,Long Buckby West & Weedon,383,169,480,383,457,500,506,545,591,631,577,525,545,384,414,6538,6707,7090
E02005628,"Woodforth Halse, Byfield & Staverton",336,178,544,427,503,493,504,555,696,812,655,522,515,379,391,6996,7174,7510
E02005629,"King's Cliffe, Woodnewton & Easton",289,119,413,279,289,329,405,453,520,638,532,455,464,352,378,5507,5626,5915
E02005630,"Oundle, Warmington & Titchmarsh",958,562,666,373,436,487,526,672,807,845,787,637,690,569,706,8201,8763,9721
E02005631,Thrapston & Brigstock,569,289,785,658,672,625,662,824,931,942,772,625,651,443,489,9079,9368,9937
E02005632,"Ringstead, Woodford & Stanwick",322,138,368,311,355,321,336,456,563,571,473,473,474,335,381,5417,5555,5877
E02005633,Raunds,439,204,593,620,654,621,607,567,701,679,578,553,630,436,460,7699,7903,8342
E02005634,Irthlingborough,485,241,679,624,701,644,571,609,722,656,559,459,478,324,388,7414,7655,8140
E02005635,Higham Ferrers,510,245,701,474,564,629,665,732,762,643,551,475,554,407,426,7583,7828,8338
E02005636,Rushden West & North,681,325,905,714,882,872,815,821,979,825,693,619,701,491,554,9871,10196,10877
E02005637,Rushden East,397,215,680,710,834,716,650,612,672,671,485,402,404,299,519,7654,7869,8266
E02005638,Rushden South,504,253,749,577,542,569,669,730,859,830,625,581,707,483,523,8444,8697,9201
E02005639,"Geddington, Rushton & Stoke Albany",231,124,357,246,277,277,282,369,471,586,476,402,447,311,353,4854,4978,5209
E02005640,Desborough,594,300,800,679,770,794,768,829,863,821,690,637,715,501,539,9406,9706,10300
E02005641,Rothwell,400,199,589,547,614,621,572,518,600,559,562,523,561,368,316,6950,7149,7549
E02005642,Kettering Brambleside,436,229,621,519,546,563,602,563,701,675,544,444,477,380,436,7071,7300,7736
E02005643,Kettering Avondale Grange,571,268,735,678,819,723,613,610,624,592,461,362,316,226,250,7009,7277,7848
E02005644,Kettering Central East,523,198,887,997,1139,1023,812,727,657,573,449,295,235,152,172,8118,8316,8839
E02005645,Kettering Town & West,556,288,943,1058,1173,1076,1007,1000,947,841,638,515,536,455,765,10954,11242,11798
E02005646,Kettering East,370,155,413,310,333,390,411,469,501,414,363,389,499,404,398,5294,5449,5819
E02005647,Kettering South,408,194,595,453,560,519,495,535,596,564,423,386,369,308,392,6195,6389,6797
E02005648,Barton Seagrave,490,245,727,571,621,628,682,704,714,668,532,460,514,445,448,7714,7959,8449
E02005649,"Burton Latimer, Broughton & Mawsley",952,390,1124,981,1204,1153,1180,1271,1362,1230,890,786,805,570,682,13238,13628,14580
E02005650,Boughton,324,144,845,795,577,578,465,436,449,392,357,355,405,274,268,6196,6340,6664
E02005651,Moulton,294,119,437,399,429,403,414,375,496,547,455,451,464,399,441,5710,5829,6123
E02005652,Sunnyside,283,141,453,422,489,502,434,417,477,455,385,361,499,363,515,5772,5913,6196
E02005653,Thorplands & Round Spinney,611,269,863,779,929,873,770,710,687,562,428,347,305,190,159,7602,7871,8482
E02005654,Overstone Lodge & Rectory Farm,577,287,777,730,810,793,727,635,605,551,464,387,319,186,191,7175,7462,8039
E02005655,Boothville & Spinney Hill,314,153,426,394,385,450,448,405,494,481,425,396,447,330,469,5550,5703,6017
E02005656,Blackthorn & Lings,531,229,651,533,610,654,639,543,475,376,307,305,247,163,136,5639,5868,6399
E02005657,Kingsthorpe,281,125,468,442,484,495,412,441,449,462,471,395,391,315,403,5628,5753,6034
E02005658,St David's,411,205,673,705,705,696,627,493,495,423,309,245,197,140,152,5860,6065,6476
E02005659,Westone,329,150,454,344,457,494,447,383,447,406,354,314,344,258,372,5074,5224,5553
E02005660,Billing & Riverside,474,201,610,475,562,555,508,514,548,584,502,440,418,245,208,6169,6370,6844
E02005661,Eastfield,521,224,683,548,601,650,626,559,566,467,335,280,221,136,208,5880,6104,6625
E02005662,Phippsville,383,164,582,540,616,584,578,579,544,563,385,273,285,251,383,6163,6327,6710
E02005663,New Duston West,244,103,358,310,388,384,403,369,425,430,324,333,359,230,236,4549,4652,4896
E02005664,Kingsley Park & Racecourse,279,134,663,659,674,605,603,489,523,431,349,217,231,184,314,5942,6076,6355
E02005665,Little Billing,443,237,679,594,754,739,730,636,605,630,504,466,424,274,248,7283,7520,7963
E02005666,King's Heath & Spencer,683,290,863,706,879,904,837,677,622,524,379,276,253,137,201,7258,7548,8231
E02005667,Lodge Farm,351,143,452,415,512,536,478,440,481,490,398,309,372,318,402,5603,5746,6097
E02005668,New Duston East,322,141,387,334,449,428,448,421,432,494,422,347,372,347,561,5442,5583,5905
E02005669,Abington Vale,326,137,454,320,344,333,433,425,460,545,439,387,375,315,421,5251,5388,5714
E02005670,Town Centre & Semilong,484,271,1360,1305,1464,1324,998,856,688,534,420,245,179,103,150,9626,9897,10381
E02005671,Abington,361,175,893,919,957,906,755,657,598,547,373,287,207,143,205,7447,7622,7983
E02005672,St Michael's Road,398,167,1092,1320,1447,1157,948,760,590,434,332,211,142,88,121,8642,8809,9207
E02005673,Stornton & Sixfields,315,143,626,696,885,795,662,573,521,455,422,305,310,220,317,6787,6930,7245
E02005674,Cliftonville & Rushmere,296,136,1090,1136,1196,960,743,575,544,501,408,285,239,176,435,8288,8424,8720
E02005675,Briar Hill & Hunsbury Hill,402,172,564,460,587,571,473,454,455,386,299,252,204,122,151,4978,5150,5552
E02005676,Delapre,420,166,543,439,463,546,523,463,459,423,357,224,244,162,201,5047,5213,5633
E02005677,"Cotton End, Brackmills & Hardingstone",462,180,1354,811,927,863,774,653,637,569,421,361,315,241,288,8214,8394,8856
E02005678,Upton & West Hunsbury,955,351,991,986,1390,1381,1258,1034,917,746,599,500,509,332,475,11118,11469,12424
E02005679,East Hunsbury,462,196,681,648,754,812,711,707,700,680,580,426,385,217,258,7559,7755,8217
E02005680,Wootton & Collingtree,682,320,855,429,490,539,716,867,839,688,466,254,286,212,299,6940,7260,7942
E02005681,"Harpole, Kislingbury & Bugbrooke",427,232,598,436,477,478,541,574,674,701,600,574,591,529,508,7281,7513,7940
E02005682,"Cogenhoe, Hackleton & Denton",395,158,468,331,398,430,488,518,569,619,573,458,485,386,375,6098,6256,6651
E02005683,"Blisworth, Roade & Yardley Gobion",821,378,976,890,1067,1111,1148,1241,1217,1120,879,685,746,559,626,12265,12643,13464
E02005684,Towcester West & Blakesley,410,192,608,419,495,540,601,635,705,733,709,577,600,444,442,7508,7700,8110
E02005685,Towcester East & Paulerspury,445,227,738,709,826,701,674,732,750,720,617,523,546,361,428,8325,8552,8997
E02005686,Middleton Cheney & Chipping Warden,393,199,540,326,413,434,494,589,693,701,586,471,532,426,516,6721,6920,7313
E02005687,Silverstone & Syresham & Helmdon,352,149,517,325,347,356,386,516,630,646,500,404,421,293,307,5648,5797,6149
E02005688,"Deanshanger, Potterspury & Old Stratford",482,248,650,453,615,674,769,741,777,749,652,516,581,392,438,8007,8255,8737
E02005689,Brackley North,512,262,756,853,948,794,678,737,921,789,580,437,434,320,402,8649,8911,9423
E02005690,Brackley South,233,108,398,402,462,370,346,381,443,479,377,266,281,236,301,4742,4850,5083
E02005691,"Kings Sutton, Greatworth & Evenley",283,128,404,291,322,367,391,441,581,626,490,425,467,323,400,5528,5656,5939
E02005692,"Finedon, Isham & Harrowden",312,154,483,384,388,400,392,489,591,577,455,436,495,396,367,5853,6007,6319
E02005693,Rixon,575,263,774,571,714,712,681,626,636,582,490,397,378,271,357,7189,7452,8027
E02005694,Redwell,384,193,543,392,413,465,570,565,652,560,568,516,512,367,326,6449,6642,7026
E02005695,Victoria & Isebrook,488,226,831,1061,1211,1158,956,774,717,581,500,361,269,205,303,8927,9153,9641
E02005696,Queensway,450,200,575,497,597,538,506,450,486,427,289,237,229,232,276,5339,5539,5989
E02005697,Central Wellingborough,280,146,567,622,755,591,528,524,555,496,380,364,303,246,442,6373,6519,6799
E02005698,Brickhill,354,171,466,391,456,476,425,392,444,420,361,281,332,278,336,5058,5229,5583
E02005699,Croyland,580,245,728,627,694,729,646,584,686,599,473,356,295,204,265,6886,7131,7711
E02005700,Earls Barton & Great Doddington,444,203,614,489,578,612,614,656,766,847,766,759,772,561,585,8619,8822,9266
E02005701,"Irchester, Wollaston & Bozeat",559,251,729,512,638,690,723,851,957,889,757,707,811,561,572,9397,9648,10207
E02005819,Stanton Hill & Skegby,286,132,414,416,447,391,346,400,457,548,461,442,401,354,317,5394,5526,5812
E02005820,The Dales & South Skegby,248,123,360,298,312,323,329,334,466,486,374,335,390,363,363,4733,4856,5104
E02005821,Huthwaite,310,151,492,454,541,498,439,417,524,443,408,351,326,280,247,5420,5571,5881
E02005822,Sutton Forest Side & New Cross,527,230,867,772,915,883,724,664,808,673,564,452,358,244,377,8301,8531,9058
E02005823,Sutton Central & Leamington,388,208,671,556,589,581,459,447,547,554,433,351,368,305,517,6378,6586,6974
E02005824,Sutton St Mary's & Ashfields,447,228,700,574,606,597,676,708,867,813,636,513,546,437,460,8133,8361,8808
E02005825,East Kirkby,407,197,610,508,500,514,454,524,592,587,516,433,459,336,409,6442,6639,7046
E02005826,Kirkby Central,338,164,527,416,505,419,415,372,454,381,379,309,254,210,268,4909,5073,5411
E02005827,Kirkby Larwood & Kingsway,432,208,648,562,654,637,649,617,781,739,591,520,434,322,465,7619,7827,8259
E02005828,Annesley & Kirkby Woodhouse,353,114,462,438,533,521,462,474,580,579,546,448,511,424,371,6349,6463,6816
E02005829,Selston,327,153,518,336,409,382,347,445,553,547,496,393,473,332,404,5635,5788,6115
E02005830,Jacksdale & Underwoood,227,122,405,344,360,277,330,377,491,553,458,415,419,372,342,5143,5265,5492
E02005831,Hucknall North & East,518,199,703,638,778,726,762,728,784,778,572,498,488,396,497,8348,8547,9065
E02005832,Hucknall Town,454,182,716,756,785,639,606,603,747,624,505,387,377,329,429,7503,7685,8139
E02005833,West Hucknall,327,173,495,405,508,460,427,504,553,608,541,449,519,408,395,6272,6445,6772
E02005834,Hucknall Westville,453,219,695,707,810,688,565,536,622,576,481,369,379,324,411,7163,7382,7835
E02005835,"Harworth, Bircotes & Blyth",540,246,848,772,773,717,635,645,887,849,749,587,577,483,641,9163,9409,9949
E02005836,"Clarborough, Beckingham & Misterton",427,192,592,423,449,442,468,627,780,820,722,621,729,564,641,7878,8070,8497
E02005837,"Ranskill, Everton & Gringley",307,124,542,569,609,581,530,528,600,679,641,545,567,407,394,7192,7316,7623
E02005838,Carlton & Langold,379,172,590,576,569,550,458,498,584,653,585,585,576,434,463,7121,7293,7672
E02005839,Retford North,256,137,449,340,398,380,308,408,508,502,484,434,450,336,449,5446,5583,5839
E02005840,Worksop North,544,281,754,669,684,713,664,708,822,787,548,422,431,269,302,7773,8054,8598
E02005842,Retford East,368,183,591,567,538,518,537,589,666,702,610,485,551,430,625,7409,7592,7960
E02005843,"Worksop West, Shireoaks & Rhodesia",350,144,495,494,566,518,465,493,616,618,487,349,322,217,258,5898,6042,6392
E02005844,Retford South,466,197,611,576,686,590,562,560,642,627,557,467,457,355,413,7103,7300,7766
E02005846,Worksop Cheapside,365,166,693,764,762,674,594,519,521,485,376,311,249,194,247,6389,6555,6920
E02005847,Worksop Town & South,309,136,608,542,535,501,455,491,584,558,477,389,397,316,395,6248,6384,6693
E02005848,"Manton, Clumber & Elkesley",304,158,451,383,385,344,359,407,571,543,463,428,454,362,409,5559,5717,6021
E02005849,"Tuxford, Markham & Rampton",469,225,671,426,437,522,540,616,815,848,732,655,717,512,552,8043,8268,8737
E02006903,Worksop Kilton,456,207,731,689,790,710,639,704,840,902,794,705,783,582,761,9630,9837,10293
E02005850,Eastwood Hall & Brinsley,298,116,402,360,407,386,359,430,515,523,540,446,555,377,435,5735,5851,6149
E02005851,Eastwood Town,326,136,467,485,499,405,381,347,472,459,443,358,369,270,338,5293,5429,5755
E02005852,Eastwood East,327,157,473,511,518,488,467,501,640,676,592,474,659,524,599,7122,7279,7606
E02005853,Kimberley North & Watnall,424,190,572,506,556,540,545,620,742,793,599,625,630,415,464,7607,7797,8221
E02005856,Bramcote,295,153,435,358,389,503,455,463,555,561,499,502,579,442,586,6327,6480,6775
E02005857,Stapleford North,319,135,419,463,509,441,434,392,426,423,343,286,285,270,306,4997,5132,5451
E02005858,Beeston North,371,169,1581,883,857,732,558,532,556,489,424,358,376,231,318,7895,8064,8435
E02005859,Stapleford South,478,197,679,648,727,700,589,606,750,723,578,455,475,370,494,7794,7991,8469
E02005860,Beeston Town,308,120,2225,1351,1305,1075,628,534,474,482,410,365,387,313,466,10015,10135,10443
E02005861,Beeston Rylands,222,91,433,585,533,543,421,373,416,389,340,277,260,181,236,4987,5078,5300
E02005862,Chilwell West,355,159,556,624,759,732,623,517,568,507,448,371,445,376,481,7007,7166,7521
E02005863,Attenborough & Chilwell East,320,155,450,419,471,584,486,484,595,564,482,455,485,407,636,6518,6673,6993
E02005864,Toton,441,195,558,409,481,556,582,634,684,667,548,470,414,328,459,6790,6985,7426
E02006906,"Kimberley South, Trowell & Awsworth",490,257,834,715,808,721,766,793,973,1048,843,759,839,600,695,10394,10651,11141
E02005865,Ravenshead & Newstead,403,162,467,446,465,459,543,573,680,708,561,555,652,535,616,7260,7422,7825
E02005866,Calverton & Woodborough,415,195,541,435,580,565,586,573,667,654,743,606,670,491,598,7709,7904,8319
E02005868,Redhill,360,177,482,447,508,493,532,459,558,525,454,410,430,317,415,6030,6207,6567
E02005869,Arnold Town,367,183,468,380,471,444,375,385,427,417,355,273,277,176,303,4751,4934,5301
E02005870,Daybrook,343,150,505,474,531,527,458,451,479,466,396,285,285,206,327,5390,5540,5883
E02005871,Plains Estate,297,152,434,427,443,423,424,437,534,521,497,475,508,387,456,5966,6118,6415
E02005872,Burton Joyce & Lambley,317,148,352,269,355,326,408,461,510,532,451,436,460,395,506,5461,5609,5926
E02005873,Woodthorpe & Arno Vale,472,225,641,542,590,588,638,705,778,818,685,648,705,537,731,8606,8831,9303
E02005874,Mapperley & Porchester,359,159,529,486,629,616,663,644,689,668,608,502,522,348,527,7431,7590,7949
E02005875,Gedling North,384,171,541,593,670,608,526,505,578,579,461,384,400,276,396,6517,6688,7072
E02005876,Gedling South,454,191,636,554,578,566,571,593,762,725,576,483,522,405,523,7494,7685,8139
E02005877,Carlton Hill,344,131,572,499,584,549,517,462,559,546,447,386,374,257,346,6098,6229,6573
E02005878,Carlton,425,222,768,674,676,672,709,650,788,774,668,565,539,376,540,8399,8621,9046
E02005879,Netherfield & Colwick,316,151,521,575,757,651,534,515,586,546,408,301,281,193,225,6093,6244,6560
E02006835,Bestwood Village,290,136,436,367,429,397,401,412,469,475,417,391,359,212,265,5030,5166,5456
E02005880,Church Warsop & Meden Vale,356,169,466,375,456,434,371,382,454,464,432,363,310,288,322,5117,5286,5642
E02005881,Market Warsop,320,134,440,423,517,447,327,361,488,518,461,360,354,251,284,5231,5365,5685
E02005882,"Manor, Hornby & Peafields",358,156,489,386,447,507,446,511,556,646,612,528,567,431,471,6597,6753,7111
E02005883,Woodhouse,450,201,626,601,684,652,553,544,588,623,547,393,382,285,323,6801,7002,7452
E02005884,Yeoman Hill & Maun Valley,220,103,417,414,474,406,326,347,453,526,494,400,373,283,288,5201,5304,5524
E02005885,Abbott Road & Pleasley Hill,409,198,595,613,687,587,538,547,667,646,603,554,520,358,453,7368,7566,7975
E02005886,Forest Town & Newlands,557,243,803,690,819,828,758,749,873,890,786,631,593,487,557,9464,9707,10264
E02005887,Mansfield Town Centre & Broomhill,457,209,958,1213,1292,1133,854,702,770,684,577,411,346,306,433,9679,9888,10345
E02005888,Newgate & Carr Bank,425,187,739,759,825,770,636,629,591,603,488,377,323,239,293,7272,7459,7884
E02005889,Grange Farm & Ladybrook,523,237,703,703,859,832,678,674,774,824,737,603,602,418,553,8960,9197,9720
E02005890,Eakring & Ling Forest,286,118,426,339,407,413,378,429,527,585,479,416,462,350,339,5550,5668,5954
E02005891,Oak Tree & Ransom Wood,362,177,560,538,516,495,446,397,491,492,426,310,226,205,265,5367,5544,5906
E02005892,"King's Walk, Berry Hill & Oakham",606,277,756,748,869,958,965,906,1058,992,772,717,724,544,736,10745,11022,11628
E02005893,Ollerton & Boughton,524,242,906,857,883,761,650,699,895,877,753,635,610,447,515,9488,9730,10254
E02005894,Edwinstowe & Clipstone,584,276,800,786,926,819,717,745,848,897,664,604,586,467,593,9452,9728,10312
E02005895,"Muskham, Sutton on Trent & Walesby",384,167,479,335,352,341,427,554,664,753,720,639,697,521,515,6997,7164,7548
E02005896,"Winthorpe, Coddington & Collingham",291,160,472,314,359,358,394,466,610,671,604,549,710,547,588,6642,6802,7093
E02005897,Bilsthorpe & Farnsfield,426,204,654,438,482,503,502,593,797,841,727,591,679,473,556,7836,8040,8466
E02005898,Rainworth & Blidworth,564,242,853,801,880,808,700,760,866,964,797,616,553,399,541,9538,9780,10344
E02005899,Newark North,535,233,999,1169,1293,1162,980,832,907,774,744,609,540,386,464,10859,11092,11627
E02005900,Southwell,382,185,771,305,252,309,393,482,535,556,521,466,609,553,666,6418,6603,6985
E02005901,Newark South East,508,226,692,713,825,780,691,672,743,695,612,520,461,363,465,8232,8458,8966
E02005902,Newark South West,398,197,611,579,638,579,502,496,609,615,551,484,517,331,466,6978,7175,7573
E02005903,Balderton,463,206,720,666,701,656,564,616,794,780,703,611,677,596,659,8743,8949,9412
E02005904,"Fernwood, Farndon & Fiskerton",501,231,597,508,509,568,653,620,812,721,657,599,596,450,538,7828,8059,8560
E02005905,"Lowdham, Bleasby & Gunthorpe",262,138,446,390,375,392,413,451,556,652,529,449,511,377,499,6040,6178,6440
E02005906,East Bridgford & Aslockton,307,139,462,378,390,418,436,520,628,680,646,534,515,365,500,6472,6611,6918
E02005907,Bingham,598,247,579,506,615,667,769,771,707,692,559,512,595,494,607,8073,8320,8918
E02005908,Radcliffe on Trent & Shelford,415,208,515,369,415,493,620,620,686,672,606,553,656,548,836,7589,7797,8212
E02005909,Lady Bay,505,242,770,475,538,608,731,718,671,579,446,389,339,214,288,6766,7008,7513
E02005910,West Bridgford,394,165,1614,883,738,702,690,666,631,529,345,324,306,181,345,7954,8119,8513
E02005911,Gamston & Holme Pierrepoint,478,232,606,475,467,567,649,656,757,685,540,439,454,289,348,6932,7164,7642
E02005912,Compton Acres & Lutterell,545,242,677,575,608,672,764,655,689,722,598,521,499,360,643,7983,8225,8770
E02005913,Edwalton,516,260,590,491,552,613,675,661,661,593,464,428,418,333,536,7015,7275,7791
E02005914,Cotgrave,383,157,496,530,697,639,529,475,535,626,499,408,393,313,378,6518,6675,7058
E02005915,"Cropwell Bishop, Kinoulton & Upper Broughton",257,118,295,234,265,285,330,361,476,528,495,409,471,343,343,4835,4953,5210
E02005916,Ruddington,385,151,423,385,558,628,557,548,589,502,477,426,407,346,466,6312,6463,6848
E02005917,"Keyworth North, Tollerton & Willoughby",248,118,358,223,228,301,324,349,455,536,458,383,480,415,596,5106,5224,5472
E02005918,Keyworth South,211,103,306,245,291,310,313,297,352,359,333,331,362,318,436,4253,4356,4567
E02005919,"Ratcliffe, Sutton Bonington & Gotham",314,149,1120,482,525,479,453,431,536,518,473,333,386,348,331,6415,6564,6878
E02005920,East Leake,360,208,524,481,579,528,503,545,606,641,630,521,610,486,551,7205,7413,7773
E02003237,"Glinton, Northborough & Maxey",313,148,409,287,263,325,365,379,532,527,499,428,433,351,428,5226,5374,5687
E02003238,Werrington,316,151,456,384,420,468,430,453,471,482,442,345,231,153,169,4904,5055,5371
E02003239,Newborough & Peakirk,405,163,525,505,535,540,513,512,654,670,587,531,548,385,519,7024,7187,7592
E02003240,"Barnack, Wittering & Wansford",381,155,491,479,504,575,541,530,540,549,394,345,336,228,253,5765,5920,6301
E02003241,Eye & Thorney,353,168,490,464,481,485,451,510,544,548,496,381,404,319,365,5938,6106,6459
E02003242,Walton,359,166,519,498,639,610,536,528,618,627,547,484,513,444,628,7191,7357,7716
E02003243,Paston,802,355,1092,1033,1209,1235,1008,844,794,673,508,440,347,203,278,9664,10019,10821
E02003244,Dogsthorpe,691,282,853,792,956,967,861,701,722,604,531,387,336,251,408,8369,8651,9342
E02003245,North Bretton & Westwood,598,245,844,779,892,898,773,629,576,438,413,328,273,157,165,7165,7410,8008
E02003246,Millfield & Bourges Boulevard,818,366,1652,1454,1546,1543,1293,1041,846,654,504,307,294,158,230,11522,11888,12706
E02003247,Bretton Park,576,238,723,723,878,870,796,677,618,566,444,420,428,262,295,7700,7938,8514
E02003248,Central Park,908,473,1578,1288,1313,1249,1113,1007,821,675,543,424,294,214,389,10908,11381,12289
E02003249,Fengate & Parnwell,861,378,1195,1123,1374,1406,1108,902,853,757,625,523,432,320,397,11015,11393,12254
E02003250,Peterborough Central,810,403,1589,1784,2026,1789,1400,1191,935,812,585,459,283,165,377,13395,13798,14608
E02003251,Longthorpe & Netherton,426,196,539,512,555,557,570,516,515,587,536,507,519,465,639,7017,7213,7639
E02003252,West Town & Woodston,792,336,1126,1266,1737,1678,1258,1052,848,740,564,369,331,197,334,11500,11836,12628
E02003253,Fletton,590,280,811,1002,1152,1062,895,833,771,684,515,368,355,256,352,9056,9336,9926
E02003254,Orton West & Castor,406,180,533,407,605,697,663,562,661,740,781,595,636,428,594,7902,8082,8488
E02003255,Stanground,679,306,946,1112,1344,1321,1085,919,892,816,694,557,518,406,604,11214,11520,12199
E02003257,Orton Malborne & Goldhay,684,295,944,838,914,966,846,671,688,540,471,413,362,213,255,8121,8416,9100
E02006877,Hargate & Orton Longueville,613,258,737,844,1044,1006,928,763,664,634,486,399,339,312,384,8540,8798,9411
E02006878,Hampton Vale,1030,393,1145,1026,1324,1393,1385,1151,828,616,395,260,214,122,192,10051,10444,11474
E02003258,Bramingham,404,210,563,524,642,626,614,546,686,732,620,536,457,408,489,7443,7653,8057
E02003259,Sundon Park,390,199,554,459,554,578,560,462,484,492,363,312,245,229,287,5579,5778,6168
E02003260,Marsh Farm,668,287,901,652,779,796,754,674,665,556,428,340,275,172,201,7193,7480,8148
E02003261,Warden Hill,366,158,550,424,409,473,449,450,461,482,408,305,309,338,498,5556,5714,6080
E02003262,Leagrave,693,357,1021,759,892,893,889,759,747,729,614,465,408,342,444,8962,9319,10012
E02003263,Limbury,787,387,1228,1017,1064,1142,1089,886,892,811,678,479,404,396,653,10739,11126,11913
E02003264,Barnfield,655,317,959,617,633,722,847,701,781,597,531,436,371,256,453,7904,8221,8876
E02003265,Stopsley North,374,155,525,519,656,660,526,486,567,675,561,468,477,315,395,6830,6985,7359
E02003266,Lewsey North,774,337,949,682,793,916,834,729,698,772,519,372,266,211,350,8091,8428,9202
E02003267,Montrose Avenue,1178,592,1848,1206,1311,1316,1358,1154,930,633,538,451,306,214,321,11586,12178,13356
E02003268,Challney,986,460,1351,992,1025,1173,1117,938,839,594,486,358,271,223,372,9739,10199,11185
E02003269,Stopsley South & Round Green,599,271,930,838,892,921,822,760,780,799,576,416,402,332,475,8943,9214,9813
E02003270,Lewsey South,535,254,773,694,766,799,691,656,607,616,477,319,311,274,534,7517,7771,8306
E02003271,Wigmore & Airport,533,212,756,813,911,939,841,726,752,814,658,469,398,225,269,8571,8783,9316
E02003272,Kingsway,943,472,1564,1089,1242,1238,1144,902,742,481,447,402,264,155,302,9972,10444,11387
E02003273,St Anns Hill,811,406,1166,966,1146,1110,1015,828,824,794,600,484,368,228,332,9861,10267,11078
E02003274,Bury Park,861,408,1388,1216,1417,1408,1225,1051,758,539,437,387,210,162,274,10472,10880,11741
E02003275,Central Luton & Park Town,666,262,2362,2586,2508,2028,1538,1078,907,747,547,393,298,163,266,15421,15683,16349
E02003276,Dallow Road,623,296,1184,1041,1115,1112,933,723,588,446,354,250,188,108,196,8238,8534,9157
E02003277,Farley Hill & Stockwood Park,852,406,1318,1052,1145,1150,1042,838,781,683,542,423,336,193,278,9781,10187,11039
E02003278,New Town,642,280,1652,1853,1863,1595,1248,970,862,791,553,352,280,186,198,12403,12683,13325
E02003279,Eastwood Park,404,168,639,508,568,552,584,541,666,704,657,582,707,570,764,8042,8210,8614
E02003280,Eastwood,564,232,740,606,711,725,719,680,719,759,710,560,653,465,602,8649,8881,9445
E02003281,Belfairs,429,226,613,455,498,534,604,650,681,692,659,596,722,607,806,8117,8343,8772
E02003282,Prittlewell,580,276,817,628,726,701,758,793,808,772,687,589,541,472,648,8940,9216,9796
E02003283,Blenheim Park,632,319,796,641,784,872,829,782,807,812,662,562,588,447,624,9206,9525,10157
E02003284,St Lukes,609,280,915,745,832,846,870,783,882,861,715,489,454,299,398,9089,9369,9978
E02003285,Westborough,634,276,922,862,1060,1104,973,907,833,821,566,443,315,221,242,9269,9545,10179
E02003286,West Leigh,479,243,603,427,445,603,724,754,751,694,588,540,554,439,590,7712,7955,8434
E02003287,Southchurch,576,264,757,583,631,651,666,648,756,721,664,519,673,496,737,8502,8766,9342
E02003288,Victoria,687,297,1214,1219,1314,1177,1081,933,901,845,703,512,402,265,380,10946,11243,11930
E02003289,Leigh,456,168,582,573,673,776,842,866,792,706,531,465,424,366,491,8087,8255,8711
E02003290,Chalkwell,418,197,592,618,769,800,799,837,771,763,619,546,549,392,712,8767,8964,9382
E02003291,Shoeburyness,610,278,931,778,850,813,770,815,887,891,807,621,668,455,459,9745,10023,10633
E02003292,Kursaal,611,286,1075,1076,1194,1132,1016,905,928,824,659,491,399,268,308,10275,10561,11172
E02003293,Southend Central,491,213,1143,1070,1050,1106,1016,894,953,877,613,520,480,369,557,10648,10861,11352
E02003294,Thorpe Bay,391,191,603,432,463,513,578,609,664,749,673,586,694,587,836,7987,8178,8569
E02003295,West Shoebury,588,286,869,689,652,683,639,704,767,819,634,528,595,455,554,8588,8874,9462
E02003296,Corringham North & London Gateway,327,173,555,402,426,437,426,485,507,558,448,423,555,337,396,5955,6128,6455
E02003297,Corringham South,407,176,618,435,465,495,471,453,521,468,415,369,432,371,405,5918,6094,6501
E02003298,Stanford East,327,159,551,445,484,481,459,437,538,515,410,351,473,322,451,5917,6076,6403
E02003299,"Orsett, Bulphan & Hordon-on-the-Hill",288,151,499,374,376,345,379,426,516,587,446,390,373,264,375,5350,5501,5789
E02003300,Stanford West,442,209,642,595,778,673,645,569,590,548,449,382,426,314,297,6908,7117,7559
E02003301,North Ockendon,685,319,958,826,1117,1068,949,855,833,772,577,497,427,311,321,9511,9830,10515
E02003302,South Ockendon,600,251,822,739,822,842,801,718,802,703,497,383,335,218,257,7939,8190,8790
E02003303,Aveley,560,263,748,623,729,796,729,595,628,641,443,369,376,216,270,7163,7426,7986
E02003304,Stifford Clays,630,279,856,616,648,752,704,743,726,631,595,481,521,333,512,8118,8397,9027
E02003305,Little Thurrock North,385,164,523,396,496,523,523,476,454,443,400,352,389,306,340,5621,5785,6170
E02003307,Chadwell St Mary,657,313,883,735,782,814,679,633,739,733,591,476,436,338,574,8413,8726,9383
E02003308,East Tilbury,485,191,616,543,706,612,562,522,484,445,403,346,324,206,169,5938,6129,6614
E02003309,Little Thurrock South,390,191,606,483,594,615,557,519,559,558,495,417,364,274,370,6411,6602,6992
E02003310,"Purfleet, South Stifford & Lakeside",872,371,1114,1152,1568,1636,1369,1127,896,756,518,354,267,134,150,11041,11412,12284
E02003311,Grays Chafford Gorges & Orsett Road,444,224,737,752,1022,954,769,719,620,641,484,293,267,219,326,7803,8027,8471
E02003312,Grays Town,497,212,668,834,1103,1097,853,642,601,458,316,187,159,114,104,7136,7348,7845
E02003313,Tilbury,1106,517,1371,1165,1342,1398,1167,1056,1007,846,755,505,419,294,348,11673,12190,13296
E02006859,South Chafford,592,261,667,496,649,768,770,756,674,449,249,159,109,71,50,5867,6128,6720
E02006926,Chafford & North Stifford,509,265,695,545,615,671,700,723,677,571,392,243,184,116,128,6260,6525,7034
E02003616,Riseley & Sharnbrook,291,155,413,235,264,298,323,409,513,558,435,351,420,313,362,4894,5049,5340
E02003617,"Harrold, Chellington & Turvey",471,234,645,386,421,450,542,648,802,827,705,557,619,495,564,7661,7895,8366
E02003618,"Clapham, Oakley & Thurleigh",528,249,644,469,436,522,603,709,728,691,567,473,536,386,498,7262,7511,8039
E02003619,"Wyboston, Great Barford & Cople",652,273,804,611,726,812,851,933,968,979,791,656,666,545,583,9925,10198,10850
E02003620,Brickhill,382,176,534,466,489,542,573,525,599,624,602,488,563,408,642,7055,7231,7613
E02003621,Putnoe,451,193,609,433,401,476,540,547,620,644,550,491,643,488,606,7048,7241,7692
E02003622,Goldington,570,275,808,665,747,665,726,698,681,680,538,433,384,319,459,7803,8078,8648
E02003623,Bromham & Biddenham,642,312,842,758,981,992,980,850,880,856,675,599,601,406,511,9931,10243,10885
E02003624,De Parys,311,173,691,477,442,449,474,371,418,434,319,256,251,222,436,5240,5413,5724
E02003625,Harpur,334,152,854,994,1030,938,779,745,681,619,494,409,354,258,543,8698,8850,9184
E02003626,Newnham,291,150,446,376,409,437,432,443,483,413,357,282,239,195,217,4729,4879,5170
E02003627,Castle & Kingsway,427,251,995,1179,1214,1060,1023,807,872,776,561,448,369,260,437,10001,10252,10679
E02003628,Queens Park,715,296,1056,900,987,1007,865,738,631,512,399,296,227,124,262,8004,8300,9015
E02003629,Kingsbrook,657,287,945,808,1025,959,905,821,766,661,554,416,332,261,404,8857,9144,9801
E02003630,Cauldwell,652,300,1091,1117,1285,1209,1006,887,810,698,514,373,287,188,258,9723,10023,10675
E02003631,Kempston North,278,114,469,399,424,448,401,373,433,412,359,328,312,186,241,4785,4899,5177
E02003632,Kempston Central & East,280,147,481,451,518,516,572,401,435,445,392,310,268,184,240,5213,5360,5640
E02003633,Kempston West & South,571,265,849,759,926,879,881,691,722,710,577,420,409,305,303,8431,8696,9267
E02003634,"Elstow, Shortstown & Wixams",866,356,1017,1057,1366,1387,1296,1001,1017,881,745,648,619,418,540,11992,12348,13214
E02003635,Wootton & Stewartby,524,236,684,731,976,883,721,608,611,584,491,357,359,280,352,7637,7873,8397
E02003599,Sandy North,301,152,452,350,398,428,383,439,473,383,358,290,252,172,194,4572,4724,5025
E02003600,Sandy South,353,142,434,389,411,416,450,442,468,487,410,391,392,288,308,5286,5428,5781
E02003601,Potton,379,167,507,477,555,525,523,515,656,645,591,516,530,346,363,6749,6916,7295
E02003602,"Blunham, Caldecote & Broom",312,138,429,285,330,397,343,386,516,612,502,422,434,361,379,5396,5534,5846
E02003603,Biggleswade West,462,189,802,840,931,912,806,716,783,717,619,522,547,375,448,9018,9207,9669
E02003604,Biggleswade East,476,203,714,779,1057,879,814,708,720,627,549,471,403,353,410,8484,8687,9163
E02003605,Cranfield & Aspley Guise,448,179,1638,1428,979,727,660,607,680,689,545,454,467,379,379,9632,9811,10259
E02003606,Houghton Conquest & Clophill,455,210,724,556,575,556,521,634,723,809,672,528,541,410,473,7722,7932,8387
E02003607,"Marston Moretaine, Lidlington & Woburn",538,250,690,649,907,870,801,778,822,861,641,503,525,379,439,8865,9115,9653
E02003608,Arlesey & Henlow,592,271,795,715,862,878,790,857,945,956,820,691,608,444,510,9871,10142,10734
E02003609,Shefford & Shillington,593,280,926,816,1016,1039,951,809,997,883,683,527,502,376,502,10027,10307,10900
E02003610,Ampthill & Millbrook,502,266,657,470,589,549,641,750,751,727,536,412,419,347,501,7349,7615,8117
E02003611,"Clifton, Meppershall & Stondon",451,210,620,532,610,675,649,665,724,724,635,519,544,376,503,7776,7986,8437
E02003612,Stotfold,616,268,728,609,861,1040,1056,952,976,790,608,605,552,436,443,9656,9924,10540
E02003613,Flitwick East,309,139,498,351,373,357,385,442,487,443,376,255,285,220,338,4810,4949,5258
E02003614,Flitwick West,333,176,510,595,651,650,555,506,611,667,561,468,396,262,241,6673,6849,7182
E02003615,"Westoning, Harlington & Silsoe",556,273,635,511,590,698,717,751,764,874,758,580,610,457,468,8413,8686,9242
E02003636,Barton-le-Clay & Upper Sundon,329,161,535,417,394,391,478,496,585,705,526,354,382,315,381,5959,6120,6449
E02003637,"Toddington, Heath & Reach",523,268,787,650,814,755,738,718,890,971,784,609,615,473,571,9375,9643,10166
E02003638,Leighton Buzzard North & East,390,161,469,473,541,555,522,489,531,593,526,488,521,353,411,6472,6633,7023
E02003639,Leighton Buzzard Central,466,182,640,675,848,778,724,705,683,665,570,433,429,317,512,7979,8161,8627
E02003640,Linslade East,253,121,340,374,471,470,452,487,438,429,390,342,422,282,359,5256,5377,5630
E02003641,Linslade West,251,114,335,265,366,390,399,361,398,397,373,304,380,261,191,4420,4534,4785
E02003642,Houghton Regis North,604,279,811,694,833,926,780,673,695,615,526,421,308,170,173,7625,7904,8508
E02003643,Leighton Buzzard South East,711,303,785,944,1338,1301,1155,970,834,717,618,481,402,328,378,10251,10554,11265
E02003644,Houghton Regis South,519,243,760,677,912,884,748,700,697,680,629,463,380,252,365,8147,8390,8909
E02003645,Dunstable East,344,150,563,516,475,489,486,478,506,605,439,317,313,270,456,5913,6063,6407
E02003646,Dunstable West,595,242,757,688,952,978,802,701,716,702,588,416,498,361,370,8529,8771,9366
E02003647,Dunstable Central,425,187,706,923,1082,988,821,683,665,717,563,420,466,327,523,8884,9071,9496
E02003648,Dunstable Manshead,293,121,452,394,474,482,395,343,392,382,364,232,223,172,300,4605,4726,5019
E02003649,Dunstable South,290,144,438,409,524,445,410,409,503,530,508,333,422,348,413,5692,5836,6126
E02003650,"Eaton Bray, Whipsnade & Holywell",267,146,400,309,361,343,357,418,544,625,597,530,542,425,455,5906,6052,6319
E02003651,Caddington & Slip End,332,149,420,322,468,440,470,487,526,567,453,464,484,418,402,5921,6070,6402
E02003719,Kings Hedges,403,194,1031,1196,1379,1121,905,732,618,602,440,362,306,237,391,9320,9514,9917
E02003720,Arbury,480,198,1211,1441,1336,1096,991,822,690,586,492,417,363,288,413,10146,10344,10824
E02003721,East Chesterton,452,376,1627,1124,1240,1118,932,750,671,603,497,390,340,235,481,10008,10384,10836
E02003722,West Chesterton,336,169,1126,1257,1123,968,819,710,647,616,492,457,416,327,414,9372,9541,9877
E02003723,Eddington & Castle,273,151,6488,3643,2814,1599,904,569,472,424,323,324,253,215,292,18320,18471,18744
E02003724,East Barnwell & Abbey,491,236,1304,1384,1376,1205,1091,824,762,625,490,391,311,177,287,10227,10463,10954
E02003725,Central & West Cambridge,452,243,8967,4397,3270,1861,1013,746,660,589,451,406,413,329,455,23557,23800,24252
E02003726,Petersfield,334,270,2548,2019,1878,1217,882,648,584,488,307,332,280,176,177,11536,11806,12140
E02003727,Romsey,292,147,1482,1726,1719,1346,1019,763,594,501,369,284,199,160,213,10375,10522,10814
E02003728,Coleridge,390,216,1488,1511,1487,1168,944,679,616,563,452,401,302,238,334,10183,10399,10789
E02003729,Cherry Hinton,546,203,725,835,1005,1021,912,797,698,617,490,409,416,314,359,8598,8801,9347
E02003730,Trumpington,1012,547,2650,2304,2336,1968,1632,1301,1042,865,617,434,408,383,454,16394,16941,17953
E02003731,Addenbrooke's & Queen Edith's,570,530,1777,1219,1226,936,788,743,706,638,576,441,397,274,480,10201,10731,11301
E02003732,Littleport,506,202,736,801,857,837,709,680,751,631,593,491,470,365,484,8405,8607,9113
E02003733,Little Downham & Sutton,399,199,532,490,534,568,583,649,643,659,641,499,580,391,429,7198,7397,7796
E02003734,North Ely,648,314,759,728,878,920,993,949,928,807,616,559,630,475,736,9978,10292,10940
E02003735,South Ely,501,278,645,546,578,630,690,733,702,562,512,428,431,390,492,7339,7617,8118
E02003736,"Haddenham, Stretham & Witchford",524,240,673,503,592,643,639,736,840,834,750,655,666,519,523,8573,8813,9337
E02003737,Soham,693,269,1600,1671,1745,1567,1385,1092,1063,970,772,670,624,436,629,14224,14493,15186
E02003738,"Isleham, Fordham & Chippenham",307,133,411,329,401,421,443,476,490,533,481,402,381,281,350,5399,5532,5839
E02003739,Burwell,320,158,410,318,370,414,410,455,542,526,426,400,376,295,422,5364,5522,5842
E02003740,Swaffham & Bottisham,336,157,407,305,323,378,386,481,467,525,402,415,384,330,445,5248,5405,5741
E02006825,Dullingham & Cheveley,270,136,388,436,455,454,439,487,490,572,427,384,446,322,416,5716,5852,6122
E02003742,"Leverington, Gorefield & Tydd St Giles",283,136,448,330,374,440,372,374,571,611,549,561,598,424,490,6142,6278,6561
E02003743,Wisbech North,627,282,1056,1039,1102,1066,947,841,835,819,658,513,519,364,566,10325,10607,11234
E02003744,Wisbech South & Peckover,606,315,1260,1175,1264,1261,1056,1041,1183,1030,917,791,752,584,773,13087,13402,14008
E02003745,"Wisbech St Mary, Waldersea & Christchurch",545,209,745,584,672,640,572,680,795,884,816,725,716,540,554,8923,9132,9677
E02003746,March North,375,156,625,503,569,555,543,497,577,610,518,425,405,323,431,6581,6737,7112
E02003747,Whittlesey,577,281,880,853,955,830,750,809,817,929,848,787,797,602,831,10688,10969,11546
E02003748,March East,334,139,497,463,508,471,435,464,528,548,516,517,545,430,517,6439,6578,6912
E02003749,"Coates, Benwick & Pondersbridge",276,130,417,332,422,413,350,377,531,522,510,410,410,293,290,5277,5407,5683
E02003750,March West,332,163,535,416,441,380,395,429,563,599,495,493,517,466,633,6362,6525,6857
E02003751,"Doddington, Wimblington & Manea",334,159,490,422,460,417,462,489,623,640,556,526,549,400,514,6548,6707,7041
E02003752,Chatteris,521,240,752,766,822,728,671,709,867,863,685,594,608,481,625,9171,9411,9932
E02003753,Yaxley & Farcet,574,301,893,716,873,874,821,892,896,825,679,604,668,412,524,9677,9978,10552
E02003754,"Stilton, Elton & Folksworth",258,140,389,285,280,343,387,420,489,544,496,398,429,277,311,5048,5188,5446
E02003755,Ramsey,397,192,617,522,603,534,483,561,676,738,645,495,540,371,490,7275,7467,7864
E02003756,Sawtry & Gidding,297,166,528,471,482,459,422,469,630,606,503,414,450,325,369,6128,6294,6591
E02003757,Warboys & Bury,278,137,455,377,493,428,411,423,503,519,552,428,394,341,341,5665,5802,6080
E02003758,"Somersham, Riptons & Raveleys",400,191,766,684,835,862,692,676,741,754,672,596,548,425,471,8722,8913,9313
E02003759,"Bluntisham, Earith & Needingworth",264,135,362,278,327,372,351,419,488,519,480,459,446,295,326,5122,5257,5521
E02003760,Huntingdon Sapley & Oxmoor,583,258,876,904,987,944,791,701,629,585,426,281,257,156,246,7783,8041,8624
E02003761,Huntingdon Hartford,252,125,420,351,418,476,377,358,449,488,410,351,430,335,448,5311,5436,5688
E02003762,"Brampton, the Stukeleys and the Alconburys",520,243,725,716,961,849,735,689,752,833,665,548,570,465,558,9066,9309,9829
E02003763,St Ives North,452,237,671,663,817,772,720,736,718,683,638,545,571,385,376,8295,8532,8984
E02003764,Huntingdon Central & West,521,241,755,919,1104,1047,883,866,798,759,519,382,341,253,417,9043,9284,9805
E02003765,St Ives South,380,166,537,509,505,542,561,568,505,493,434,405,437,386,549,6431,6597,6977
E02003766,Godmanchester,376,161,529,510,640,617,585,594,558,522,515,343,375,271,310,6369,6530,6906
E02003767,"Kimbolton, Great Staughton & Molesworth",334,190,494,308,283,329,411,523,607,676,538,427,418,332,370,5716,5906,6240
E02003768,"Houghton, Hemingford & Fenstanton",465,223,606,467,562,583,631,690,834,783,737,648,744,645,719,8649,8872,9337
E02003769,Buckden & Perry,277,135,474,412,499,498,504,539,615,665,636,503,540,472,441,6798,6933,7210
E02003770,"Little Paxton, Love's Farm & Great Gransden",644,234,665,634,846,947,937,784,778,712,566,510,536,394,392,8701,8935,9579
E02003771,St Neots Priory Park,289,138,535,443,495,434,437,482,573,517,411,312,355,266,417,5677,5815,6104
E02003772,St Neots Eaton Ford,262,151,435,360,410,434,455,456,561,480,451,451,492,400,435,5820,5971,6233
E02003773,St Neots Eynesbury,480,225,832,793,904,810,751,771,870,820,602,461,509,384,444,8951,9176,9656
E02003774,St Neots Eaton Socon,222,100,406,373,411,377,396,408,380,456,360,322,348,285,391,4913,5013,5235
E02003775,Willingham & Over,379,202,477,415,480,501,507,550,599,574,488,407,426,327,345,6096,6298,6677
E02003776,Cottenham,394,216,483,405,425,470,511,515,537,504,423,379,431,305,441,5829,6045,6439
E02003777,"Longstanton, Swavesey & Oakington",535,251,546,627,884,941,877,811,660,536,440,407,375,319,365,7788,8039,8574
E02003778,Waterbeach and Landbeach,264,96,344,410,614,586,589,422,433,447,320,307,313,227,313,5325,5421,5685
E02003779,Bar Hill & Boxworth,226,87,288,285,374,403,374,362,346,383,348,322,314,233,222,4254,4341,4567
E02003780,"HIston, Impington & Orchard Park",651,293,1045,990,935,1006,1013,981,840,716,612,522,544,368,692,10264,10557,11208
E02003781,"Milton, Fen Ditton & Quy",267,148,467,546,597,598,530,500,514,549,379,330,286,251,305,5852,6000,6267
E02003783,Girton & Barton,349,147,1048,482,515,520,596,549,522,531,464,423,395,351,607,7003,7150,7499
E02003784,Hardwick & Highfields,531,267,606,445,446,496,662,719,822,705,608,488,524,415,509,7445,7712,8243
E02003785,Fulbourn & Teversham,441,201,556,642,765,768,753,663,639,619,488,466,391,359,489,7598,7799,8240
E02003786,Great Shelford & Stapleford,353,159,362,347,410,463,509,521,505,478,418,379,397,343,569,5701,5860,6213
E02003787,"Barrington, Orwell & Gamlingay",360,164,459,346,408,433,461,522,595,639,583,525,558,410,536,6475,6639,6999
E02003788,"Little Shelford , Foxton & Haslingfield",459,203,499,445,558,576,698,627,629,606,510,359,439,395,465,6806,7009,7468
E02003789,Sawston,357,148,488,420,585,594,612,569,523,510,448,422,463,345,463,6442,6590,6947
E02003790,Linton & Balsham,515,262,660,488,518,506,670,714,795,799,672,607,658,479,677,8243,8505,9020
E02003791,"Duxford, Whittlesford & the Abingtons",446,187,544,421,519,532,652,650,702,697,539,508,463,406,449,7082,7269,7715
E02003792,"Meldreth, Melbourn & Great Chishill",498,244,659,591,655,670,717,689,783,763,683,575,633,505,635,8558,8802,9300
E02003793,Bassingbourn & the Mordens,363,192,466,345,426,421,493,510,616,634,541,383,432,332,337,5936,6128,6491
E02006873,Cambourne,852,364,646,501,721,1018,1072,930,694,474,268,136,111,117,155,6843,7207,8059
E02006874,"Papworth, Caxton & Fen Drayton",625,282,695,525,740,872,880,921,893,748,562,445,433,323,346,8383,8665,9290
E02004424,Billericay North East,405,198,541,334,365,421,494,566,626,511,464,397,440,352,389,5900,6098,6503
E02004425,Billericay Queen's Park,383,170,507,431,513,537,511,549,612,524,490,356,382,267,410,6089,6259,6642
E02004426,Billericay Central & Sunnymede,413,201,580,477,571,536,610,591,654,622,490,361,422,357,544,6815,7016,7429
E02004427,Billericay Tye Common,375,171,485,358,493,501,546,564,642,606,515,417,513,458,665,6763,6934,7309
E02004428,Wickford North East,306,157,483,423,499,454,434,484,532,474,434,325,382,314,525,5763,5920,6226
E02004429,Wickford West,339,174,581,418,423,426,433,493,574,647,489,462,571,466,606,6589,6763,7102
E02004430,Wickford Shotgate,460,195,620,480,604,537,545,649,643,630,489,418,433,348,356,6752,6947,7407
E02004431,Wickford South,502,225,745,755,807,776,704,721,761,647,534,389,411,301,293,7844,8069,8571
E02004432,Bursteads,357,201,547,377,401,474,453,488,572,521,444,427,417,326,360,5807,6008,6365
E02004433,Steeple View & Noak Bridge,444,207,657,605,664,639,566,513,657,618,575,425,406,323,386,7034,7241,7685
E02004434,Felmore & Bowers Gifford,434,219,641,636,726,673,573,595,617,658,543,457,423,281,272,7095,7314,7748
E02004435,Whitmore Way & Fremnells,545,261,801,697,858,860,685,590,671,600,508,391,326,213,311,7511,7772,8317
E02004436,Chalvedon,543,250,757,583,701,636,612,555,572,441,451,408,397,223,233,6569,6819,7362
E02004437,Laindon West & Southfields,504,220,598,662,893,841,696,604,602,643,589,460,523,313,410,7834,8054,8558
E02004438,Basildon Central & Pipps Hill,525,216,798,724,907,892,733,603,597,551,544,351,318,217,408,7643,7859,8384
E02004439,Laindon Central,672,298,930,752,896,888,769,644,676,534,412,288,251,176,200,7416,7714,8386
E02004440,Laindon East & Lee Chapel North,530,219,767,760,828,887,775,631,628,683,470,314,277,224,409,7653,7872,8402
E02004441,Eversley,445,200,640,584,614,618,563,503,513,537,515,435,445,339,311,6617,6817,7262
E02004442,Barstable,594,268,771,656,718,680,648,553,604,537,460,354,291,200,251,6723,6991,7585
E02004443,Lee Chapel South & Kingswood,422,208,759,966,1140,1063,772,667,693,693,534,407,395,265,454,8808,9016,9438
E02004444,Langdon Hills,410,222,676,651,656,651,582,683,688,754,570,490,451,315,386,7553,7775,8185
E02004445,Vange & Pitsea,433,198,678,647,722,647,578,552,627,549,503,382,370,276,309,6840,7038,7471
E02004446,Steeple Bumpstead & Great Yeldham,353,159,449,325,299,342,374,464,601,711,561,474,490,330,352,5772,5931,6284
E02004447,"Bures Hamlet, Maplestead & Belchamp",236,127,382,235,237,252,289,377,518,618,486,477,496,370,360,5097,5224,5460
E02004448,"Hedingham, Gosfield & Greenstead Green",344,176,498,452,518,455,455,465,605,599,495,448,469,362,463,6284,6460,6804
E02004449,Halstead Central & West,450,179,620,529,555,530,606,613,693,607,495,447,441,363,379,6878,7057,7507
E02004450,"Panfield, Finchingfield & Bardfield",247,134,401,308,335,313,301,431,574,625,571,430,487,346,388,5510,5644,5891
E02004451,Halstead East & Colnes,451,198,664,509,529,508,530,656,702,707,633,617,613,504,599,7771,7969,8420
E02004452,Bocking Churchstreet & Blackwater,458,220,640,422,516,600,619,629,691,640,619,520,614,442,586,7538,7758,8216
E02004453,Bocking,388,188,555,493,614,520,470,479,476,503,395,322,325,283,343,5778,5966,6354
E02004454,Central Braintree,357,156,679,696,802,769,670,634,631,602,507,427,454,344,452,7667,7823,8180
E02004455,Braintree West & Rayne,404,237,641,415,431,461,509,578,729,561,486,402,475,351,321,6360,6597,7001
E02004456,Braintree South,480,220,674,698,799,740,686,670,734,617,486,487,418,316,347,7672,7892,8372
E02004457,Silver End & Stisted,561,263,759,703,803,692,649,695,802,781,610,504,500,346,480,8324,8587,9148
E02004458,Great Notley & Black Notley,595,291,773,535,518,606,640,743,863,678,544,444,471,361,504,7680,7971,8566
E02004459,Coggeshall & Kelvedon,521,270,702,484,532,623,602,793,904,769,682,653,714,504,661,8623,8893,9414
E02004460,North Witham,450,208,685,636,815,694,634,590,648,663,541,493,548,432,400,7779,7987,8437
E02004461,West Witham,339,173,460,412,461,465,398,402,421,365,252,232,287,157,129,4441,4614,4953
E02004462,Witham Town,479,216,696,900,1023,899,813,745,726,673,539,554,547,400,603,9118,9334,9813
E02004463,"Witham South, Hatfield Peverel & White Notley",355,186,500,486,514,549,535,563,584,636,570,529,491,397,523,6877,7063,7418
E02004464,Kelvedon Hatch & Doddinghurst,496,249,791,624,505,511,618,620,827,892,746,646,689,590,712,8771,9020,9516
E02004465,Ingatestone & Mountnessing,259,173,468,381,388,374,396,392,491,552,443,322,374,308,526,5415,5588,5847
E02004466,Hutton,460,211,632,519,607,602,635,544,593,598,486,425,358,297,473,6769,6980,7440
E02004467,Brentwood North,435,222,561,507,616,714,607,593,568,544,400,389,401,308,365,6573,6795,7230
E02004468,Shenfield & Hutton Mount,541,271,712,510,478,663,737,812,823,903,698,550,542,530,838,8796,9067,9608
E02004469,Brook Street & Pilgrim's Hatch,354,162,504,424,477,468,527,477,542,559,482,396,396,291,375,5918,6080,6434
E02004470,Brentwood Central,448,234,799,1082,1340,1145,926,872,830,673,571,427,403,342,579,9989,10223,10671
E02004471,Brentwood South & Warley,428,214,536,575,724,685,627,603,592,622,578,432,386,281,446,7087,7301,7729
E02004472,"Herongate, Ingrave & West Horndon",285,153,447,356,384,396,370,433,503,549,444,360,361,217,387,5207,5360,5645
E02004473,Benfleet North,406,194,583,481,538,479,508,509,551,535,479,401,486,406,497,6453,6647,7053
E02004474,New Thundersley,335,172,525,462,482,477,492,468,597,630,538,442,536,466,567,6682,6854,7189
E02004475,Benfleet Appleton,322,149,517,431,383,407,402,444,543,504,426,396,444,384,435,5716,5865,6187
E02004476,Thundersley Glen,395,200,586,457,439,469,469,569,667,646,503,407,566,453,541,6772,6972,7367
E02004477,Hadleigh North,196,100,341,291,308,345,320,299,412,468,420,410,493,393,536,5036,5136,5332
E02004478,Hadleigh South,309,150,522,409,384,432,370,441,495,489,427,360,403,330,586,5648,5798,6107
E02004479,South Benfleet,327,163,550,462,525,503,508,494,633,689,519,426,547,443,554,6853,7016,7343
E02004480,Canvey Island Winter Gardens,403,182,580,432,530,519,426,448,516,481,448,401,447,281,224,5733,5915,6318
E02004481,Canvey Island Newlands,258,128,415,330,352,331,327,317,458,481,441,483,688,612,687,5922,6050,6308
E02004482,Canvey Island North West,540,252,836,634,655,606,569,543,621,580,523,442,447,309,385,7150,7402,7942
E02004483,Canvey Island South West,319,163,558,450,492,441,424,470,595,577,633,581,663,510,560,6954,7117,7436
E02004484,Canvey Island Leigh Beck,364,187,647,504,534,490,502,535,655,704,640,617,674,499,521,7522,7709,8073
E02004485,Great Leighs & the Walthams,557,240,650,561,755,780,730,712,694,649,512,421,487,355,381,7687,7927,8484
E02004486,South Broomfield,450,215,494,480,612,668,671,630,641,580,537,443,508,417,575,7256,7471,7921
E02004487,"Melbourne Park, Chignall & Pleshey",444,213,602,458,521,597,543,532,567,538,427,414,435,297,352,6283,6496,6940
E02004488,Springfield North,473,230,645,638,822,806,822,730,622,586,523,530,514,346,444,8028,8258,8731
E02004489,Boreham & Little Baddow,667,341,790,504,582,585,690,820,789,712,520,429,451,332,374,7578,7919,8586
E02004490,Melbourne,502,241,757,603,651,638,594,577,591,504,417,345,299,246,327,6549,6790,7292
E02004491,Springfield South & Coronation Park,441,170,506,513,521,539,554,547,583,616,461,372,359,274,367,6212,6382,6823
E02004492,Chelmer Village,475,252,659,723,747,748,770,763,796,652,543,403,360,230,270,7664,7916,8391
E02004493,Waterhouse Lane & Admirals Park,482,250,828,922,1065,952,909,797,756,685,541,400,362,268,427,8912,9162,9644
E02004494,Central Chelmsford,357,145,1500,2122,2171,1492,1138,863,768,598,442,330,356,280,520,12580,12725,13082
E02004495,Writtle & Highwood,344,148,742,448,431,505,516,524,641,637,561,484,525,489,707,7210,7358,7702
E02004496,Moulsham West,450,204,540,467,518,673,683,672,643,513,410,302,331,306,550,6608,6812,7262
E02004497,Great Baddow North & East,382,199,505,415,428,455,533,536,563,604,501,426,486,493,714,6659,6858,7240
E02004498,Great Baddow South & West,573,256,651,650,734,784,730,744,771,655,535,447,518,394,492,8105,8361,8934
E02004499,Moulsham East,331,173,487,405,495,500,462,521,521,468,412,328,374,314,354,5641,5814,6145
E02004500,Danbury & Bicknacre,439,227,673,431,460,537,591,622,786,765,661,579,622,542,662,7931,8158,8597
E02004501,Galleywood,302,151,453,399,361,454,425,428,538,510,454,448,504,360,466,5800,5951,6253
E02004502,"Margaretting, Stock & Ramsden",313,154,482,332,375,425,453,496,652,671,542,527,453,426,537,6371,6525,6838
E02004503,South Woodham Ferrers North,389,196,557,517,523,583,593,536,519,566,492,495,564,369,342,6656,6852,7241
E02004504,South Woodham Ferrers South,352,185,646,540,620,527,517,555,574,621,589,566,495,261,285,6796,6981,7333
E02004505,Rettendon & Runwell,252,109,379,328,432,390,338,353,460,460,496,364,509,387,492,5388,5497,5749
E02004506,"Horkesley Heath, Langham & Dedham",354,171,498,371,406,398,451,513,603,597,520,447,485,363,450,6102,6273,6627
E02004507,Highwoods,610,317,768,711,840,734,841,824,848,652,503,363,345,236,258,7923,8240,8850
E02004508,West Bergholt & Wormingford,330,150,424,289,319,389,467,461,541,556,473,391,458,370,404,5542,5692,6022
E02004509,Mile End & Braiswick,840,358,1074,1439,1828,1633,1499,1247,1023,846,572,427,422,300,356,12666,13024,13864
E02004512,Central Colchester,462,205,881,1147,1293,1185,989,821,774,654,503,425,469,375,639,10155,10360,10822
E02004513,Greenstead,466,194,3727,2080,1314,885,663,538,555,515,427,337,340,248,277,11906,12100,12566
E02004514,Lexden,341,168,470,278,330,341,401,481,462,451,381,301,334,269,434,4933,5101,5442
E02004515,Marks Tey & Wakes Colne,508,220,667,620,723,644,669,669,745,693,521,502,539,386,417,7795,8015,8523
E02004516,New Town & Hythe,635,287,1526,1187,1320,1219,1054,878,852,712,492,360,307,208,212,10327,10614,11249
E02004517,Stanway,477,233,640,564,696,659,698,648,660,594,555,476,581,452,629,7852,8085,8562
E02004518,Abbey Field,433,215,1398,1220,1075,1027,865,782,638,503,358,255,330,228,285,8964,9179,9612
E02004519,Prettygate & Westlands,380,209,504,379,407,454,506,524,558,535,517,462,495,399,621,6361,6570,6950
E02004520,Shrub End,557,241,704,694,746,746,622,518,523,523,378,287,274,195,195,6405,6646,7203
E02004521,Old Heath & Rowhedge,455,175,672,687,799,707,582,630,673,691,623,481,444,307,395,7691,7866,8321
E02004522,Wivenhoe & University,324,204,4502,1434,808,618,574,582,535,558,495,488,534,446,445,12019,12223,12547
E02004523,Monkwick,566,242,836,745,900,802,739,645,672,744,537,428,411,266,346,8071,8313,8879
E02004524,"Layer-de-la-Haye, Abberton & Mersea East",404,214,530,353,411,401,504,598,754,700,652,589,620,451,458,7021,7235,7639
E02004525,Tiptree,316,164,572,431,529,475,391,502,600,594,521,483,670,548,573,6889,7053,7369
E02004526,West Mersea,276,143,427,269,279,268,349,409,518,582,555,584,746,576,742,6304,6447,6723
E02006922,Parson's Heath,649,290,1127,925,968,1030,977,890,1040,965,826,793,841,735,911,12028,12318,12967
E02004527,"North Weald, Matching & Sheering",440,211,661,546,609,553,593,615,790,729,669,503,537,437,507,7749,7960,8400
E02004528,"Roydon, Lower Nazeing & Epping Green",407,217,713,669,717,604,610,656,757,850,743,581,572,473,578,8523,8740,9147
E02004529,"Fyfield, High Ongar & Stapleford Abbotts",342,184,580,447,414,413,412,449,603,733,612,458,468,333,391,6313,6497,6839
E02004530,Chipping Ongar,381,155,445,365,429,451,426,429,500,511,427,399,405,322,479,5588,5743,6124
E02004531,Epping North,288,157,425,357,449,504,573,501,554,490,431,379,391,286,432,5772,5929,6217
E02004532,Epping South,290,113,358,363,454,443,463,499,473,429,406,349,366,285,368,5256,5369,5659
E02004533,Waltham Abbey North,359,172,616,466,581,536,535,489,565,567,441,401,419,311,468,6395,6567,6926
E02004534,Waltham Abbey South,467,214,664,566,707,673,659,646,728,602,459,380,379,338,354,7155,7369,7836
E02004535,Waltham Abbey West & Outer,241,125,432,404,442,413,371,393,498,514,427,354,364,296,361,5269,5394,5635
E02004536,Theydon Bois & Abridge,279,139,449,337,333,327,408,384,497,499,431,400,431,299,441,5236,5375,5654
E02004537,Loughton East,460,221,801,731,779,835,784,636,700,687,534,403,303,234,305,7732,7953,8413
E02004538,Loughton North,485,240,805,692,732,726,793,697,749,798,630,449,494,400,566,8531,8771,9256
E02004539,Loughton South,393,190,619,478,665,690,641,594,617,539,470,337,311,261,346,6568,6758,7151
E02004540,Loughton West,299,174,469,383,441,497,473,465,481,492,406,307,290,223,329,5256,5430,5729
E02004541,Buckhurst Hill,580,264,814,745,880,970,1018,972,951,920,706,553,569,502,670,10270,10534,11114
E02004542,Chigwell,338,164,500,428,487,453,486,471,476,542,480,418,405,286,410,5842,6006,6344
E02004543,Grange Hill,405,206,640,561,637,664,591,526,509,471,407,338,331,250,388,6313,6519,6924
E02004544,Old Harlow & Newhall,521,222,715,760,1026,1003,903,752,663,699,552,489,436,309,403,8710,8932,9453
E02004545,Mark Hall & Templefields,461,216,686,618,715,664,605,519,590,558,452,411,287,193,318,6616,6832,7293
E02004546,Nettleswell,446,203,664,661,825,841,672,581,571,576,490,405,295,192,326,7099,7302,7748
E02004547,Little Parndon & Hare Street,526,250,770,903,1080,987,911,674,645,595,576,414,277,208,338,8378,8628,9154
E02004548,Church Langley,467,234,680,516,649,716,671,722,790,652,442,344,320,227,222,6951,7185,7652
E02004549,Bush Fair & Brays Grove,475,198,682,535,702,655,620,502,581,561,516,363,281,213,392,6603,6801,7276
E02004550,Passmores & The High,472,228,703,669,846,873,715,577,592,548,449,371,312,234,481,7370,7598,8070
E02004551,Potter Street,449,221,608,494,625,661,588,483,481,517,481,404,304,254,361,6261,6482,6931
E02004552,Great Parndon & Katherines,326,150,467,446,524,505,499,416,446,499,466,432,417,261,262,5640,5790,6116
E02004553,Staple Tye & Latton Bush,467,181,597,619,815,725,599,486,517,519,397,317,262,220,311,6384,6565,7032
E02004554,Kingsmoor,450,233,655,539,637,656,600,549,527,572,451,361,317,255,278,6397,6630,7080
E02004555,"Tollesbury, Tolleshunt & Goldhanger",253,145,455,335,297,333,339,435,518,532,501,470,505,352,395,5467,5612,5865
E02004556,"Great Totham, Wickham Bishops & Woodham",370,187,500,346,338,388,426,481,647,697,559,511,565,534,545,6537,6724,7094
E02004557,Heybridge,412,199,630,531,586,550,507,606,660,668,590,526,538,374,456,7222,7421,7833
E02004558,Maldon North,260,133,464,380,395,386,361,403,517,550,445,364,449,378,656,5748,5881,6141
E02004559,Maldon South,361,190,628,456,482,422,438,479,654,651,582,503,550,463,540,6848,7038,7399
E02004560,"Southminster, Bradwell & Dengie Peninsula",400,228,670,514,595,546,530,573,800,834,691,592,636,482,496,7959,8187,8587
E02004561,"Mayland, Althorne & Cold Norton",440,215,823,592,577,509,568,673,949,929,917,729,783,554,625,9228,9443,9883
E02004562,Burnham-on-Crouch,359,172,536,442,490,426,496,588,665,661,654,632,635,538,525,7288,7460,7819
E02004563,Hullbridge,271,124,437,360,351,310,316,400,499,561,532,454,636,494,563,5913,6037,6308
E02004564,Ashingdon,365,176,636,457,461,400,462,483,647,654,621,539,550,435,553,6898,7074,7439
E02004565,Hockley & Hawkwell West,708,337,1165,822,954,908,946,994,1234,1250,1115,906,931,844,1034,13103,13440,14148
E02004566,Rochford Town & Canewdon,300,143,481,432,420,417,333,371,463,396,320,275,293,202,305,4708,4851,5151
E02004567,Rayleigh North East,397,203,597,436,478,447,536,576,682,617,535,448,561,422,649,6984,7187,7584
E02004568,Rayleigh North West,493,227,664,545,620,675,616,695,728,652,480,390,414,322,354,7155,7382,7875
E02004569,Rochford Outer & Hawkwell East,421,187,671,626,629,623,596,596,651,634,515,444,457,368,471,7281,7468,7889
E02004570,Rayleigh South West,428,181,587,468,473,566,552,606,683,655,544,496,584,490,673,7377,7558,7986
E02004571,Rayleigh South East,404,187,525,392,405,447,491,531,594,640,509,446,567,455,607,6609,6796,7200
E02004572,Great Wakering & Foulness,403,193,605,543,599,493,478,483,599,662,588,481,511,354,391,6787,6980,7383
E02004573,Harwich Town & Dovercourt,322,158,549,439,409,368,370,406,462,507,402,362,333,271,359,5237,5395,5717
E02004574,Harwich Parkeston,423,184,608,465,500,469,454,450,490,478,417,419,460,360,458,6028,6212,6635
E02004575,Manningtree & Mistley,513,251,677,633,800,720,739,833,884,987,926,798,781,633,794,10205,10456,10969
E02004576,Harwich West & South,410,206,657,365,444,457,493,562,663,747,668,660,674,575,729,7694,7900,8310
E02004577,Elmstead Market & Ardleigh,296,120,398,345,368,373,383,400,495,508,506,367,357,276,314,5090,5210,5506
E02004578,Walton & Frinton Coastal,264,135,392,325,323,262,313,332,489,550,615,656,781,640,892,6570,6705,6969
E02004579,Weeley & Thorpe-le-Soken,330,165,503,354,430,385,434,478,618,711,679,678,738,534,562,7104,7269,7599
E02004580,Frinton West & Kirby,447,211,662,435,501,450,528,576,787,979,995,1083,1338,1107,1414,10855,11066,11513
E02004581,"Alresford, Great Bentley & Thorrington",383,192,584,427,502,477,484,581,643,713,628,627,678,555,598,7497,7689,8072
E02004582,Clacton North,259,133,387,345,365,305,257,337,487,531,585,607,692,589,704,6191,6324,6583
E02004583,Brightlingsea & Point Clear,401,184,597,476,484,458,470,551,746,702,675,599,749,585,652,7744,7928,8329
E02004584,Holland-on-Sea,192,92,288,260,234,214,234,266,391,474,587,597,851,713,905,6014,6106,6298
E02004585,Clacton Bocking's Elm,452,191,661,549,579,451,493,487,608,668,653,599,726,521,556,7551,7742,8194
E02004586,Clacton East,385,173,623,469,471,449,383,407,567,633,614,562,642,516,805,7141,7314,7699
E02004587,Clacton Rush Green,413,210,656,559,552,461,436,441,534,540,524,496,487,388,455,6529,6739,7152
E02004588,Clacton Central,367,151,664,583,601,463,419,477,541,560,513,368,353,301,532,6375,6526,6893
E02004589,Clacton West,356,162,555,463,477,386,388,400,490,540,527,424,516,417,623,6206,6368,6724
E02004590,Jaywick & St Osyth,313,144,510,372,420,387,375,461,723,801,745,742,826,672,767,7801,7945,8258
E02004591,"Audley End, Ashdon & the Chesterfords",400,210,489,378,450,459,491,567,612,653,531,456,479,343,409,6317,6527,6927
E02004592,Saffron Walden Town,698,346,858,716,863,1014,991,1007,980,890,803,735,707,551,911,11026,11372,12070
E02004593,"Newport, Littlebury & Clavering",445,194,546,444,438,506,610,663,741,750,684,585,615,411,533,7526,7720,8165
E02004594,"Thaxted, Great Sampford & Radwinter",427,202,783,599,650,623,594,559,678,685,565,463,519,403,480,7601,7803,8230
E02004595,Stansted Mountfitchet & Elsenham,705,349,925,851,1051,1122,1149,1028,1187,1126,929,748,790,603,705,12214,12563,13268
E02004596,"Takeley, Airport & Mountfitchet South",560,249,748,524,710,822,871,756,820,748,653,468,475,369,421,8385,8634,9194
E02004597,Great Dunmow,418,186,618,552,599,646,597,570,693,676,570,463,451,357,450,7242,7428,7846
E02004598,"Flitch Green, Felsted & High Easter",688,371,871,564,614,631,660,776,892,907,743,592,588,475,631,8944,9315,10003
E02004599,"Hatfield Heath, Hallingburys & Rodings",420,206,602,370,396,444,465,586,688,722,595,443,458,362,451,6582,6788,7208
E02004843,Hoddesdon Ware Road,412,205,637,364,415,448,514,556,601,520,391,353,450,390,471,6110,6315,6727
E02004844,Rye Park,407,203,652,509,576,588,649,603,542,551,415,312,276,216,343,6232,6435,6842
E02004845,Hoddesdon Town,355,148,571,600,699,670,586,574,651,553,501,359,397,324,500,6985,7133,7488
E02004846,Broxbourne Town,367,147,494,364,355,394,450,488,541,524,429,395,370,314,447,5565,5712,6079
E02004847,Wormley & Turnford,579,257,767,641,850,871,809,719,711,688,568,456,419,315,376,8190,8447,9026
E02004848,Flamstead End,396,196,621,508,550,635,532,499,599,578,488,336,366,288,317,6317,6513,6909
E02004849,Goffs Oak,340,166,588,401,439,441,429,420,664,622,498,381,377,282,351,5893,6059,6399
E02004850,Cheshunt Coopers Walk,357,177,572,528,583,603,537,519,578,583,455,331,309,279,386,6263,6440,6797
E02004851,Rosedale,335,145,461,367,400,447,427,413,424,415,391,298,292,230,280,4845,4990,5325
E02004852,Cheshunt Central,400,171,625,575,648,735,601,557,574,547,404,344,321,287,510,6728,6899,7299
E02004853,Churchgate,375,162,612,410,526,453,527,462,515,471,425,320,322,239,347,5629,5791,6166
E02004854,Cheshunt South,345,170,596,596,658,663,567,512,573,565,404,313,341,267,475,6530,6700,7045
E02004855,Waltham Cross Town,466,192,696,715,859,803,691,627,574,534,437,294,253,194,249,6926,7118,7584
E02004856,"Markyate, Flamstead & Gaddesden",288,143,360,302,386,381,453,438,496,498,399,356,294,198,244,4805,4948,5236
E02004857,Tring West & Long Marston,348,249,464,342,353,407,403,480,541,516,385,326,341,236,394,5188,5437,5785
E02004858,Tring North,277,154,399,278,353,373,379,371,401,394,335,255,241,205,202,4186,4340,4617
E02004859,"Tring East, Wigginton & Aldbury",285,117,336,225,227,334,357,419,405,469,408,303,385,249,318,4435,4552,4837
E02004860,Woodhall Farm,265,131,419,448,573,559,528,450,414,353,328,280,222,132,105,4811,4942,5207
E02004861,Northchurch & Potten End,292,123,330,226,264,285,372,402,446,535,427,355,389,311,468,4810,4933,5225
E02004862,Grovehill,448,158,564,552,635,694,664,550,501,472,463,490,425,224,218,6452,6610,7058
E02004863,Highfield,456,185,582,574,739,772,616,578,537,492,407,331,260,218,374,6480,6665,7121
E02004864,Berkhamsted Town,300,131,395,312,401,464,485,562,534,506,413,377,358,266,441,5514,5645,5945
E02004865,Gadebridge & Old Town,253,116,411,422,448,456,412,381,457,468,357,243,227,153,252,4687,4803,5056
E02004866,Warners End,360,151,518,443,479,510,498,447,486,480,459,346,250,198,331,5445,5596,5956
E02004867,Berkhamsted West,422,174,421,283,372,459,560,599,511,456,357,293,339,239,348,5237,5411,5833
E02004868,Maylands & Adeyfield,378,148,523,610,725,743,642,455,429,461,401,300,246,205,359,6099,6247,6625
E02004869,Berkhamsted South,346,154,367,292,394,464,499,547,502,452,328,271,249,212,296,4873,5027,5373
E02004870,Hemel Hempstead Town,576,222,967,1051,1224,1104,970,866,818,736,606,488,377,290,548,10045,10267,10843
E02004871,Chaulden,271,113,405,364,446,456,401,341,388,372,325,248,198,159,248,4351,4464,4735
E02004872,Leverstock Green,360,176,547,420,499,517,559,511,522,549,501,367,394,321,489,6196,6372,6732
E02004873,Boxmoor & Apsley,483,250,710,751,1046,994,961,876,815,778,655,497,489,357,433,9362,9612,10095
E02004874,Corner Hall,266,145,453,394,505,523,490,426,428,479,392,329,265,180,246,5110,5255,5521
E02004875,Nash Mills & Bennetts End,591,295,812,730,906,897,899,751,735,712,531,435,360,254,318,8340,8635,9226
E02004876,Bovingdon & Chipperfield,473,218,755,724,771,680,692,749,783,755,649,518,521,500,516,8613,8831,9304
E02004877,Kings Langley,235,127,409,282,335,333,374,399,416,459,350,269,279,251,422,4578,4705,4940
E02004896,Potters Bar Parkfield,290,159,693,608,577,561,550,528,585,655,523,468,473,424,806,7451,7610,7900
E02004897,Potters Bar Furzefield,411,179,615,391,422,438,537,475,577,502,426,359,399,274,351,5766,5945,6356
E02004898,Potters Bar Oakmere,414,212,714,560,600,611,590,544,571,606,490,435,368,307,409,6805,7017,7431
E02004899,Shenley & South Mimms,328,174,449,325,330,399,417,444,470,470,374,301,317,200,316,4812,4986,5314
E02004900,Radlett,487,240,731,536,488,553,645,677,706,755,565,446,413,372,552,7439,7679,8166
E02004901,Borehamwood Cowley Hill,572,225,806,730,929,898,883,734,732,737,518,375,343,228,322,8235,8460,9032
E02004902,Borehamwood Brookmeadow,493,224,650,621,789,847,814,658,626,551,469,350,345,216,284,7220,7444,7937
E02004903,Bushey North,467,249,669,557,652,702,659,616,594,556,429,324,304,195,312,6569,6818,7285
E02004904,Borehamwood Kenilworth,337,181,507,449,535,587,601,546,508,513,374,296,256,164,210,5546,5727,6064
E02004905,Elstree & Aldenham,395,189,559,473,471,505,528,516,503,530,453,338,366,257,353,5852,6041,6436
E02004906,Borehamwood Hillside,594,278,777,824,1010,1128,1031,917,727,724,595,446,409,276,354,9218,9496,10090
E02004907,Bushey Central,579,284,869,653,710,807,872,858,801,824,677,517,576,468,551,9183,9467,10046
E02004908,Bushey Heath,559,262,796,548,564,717,764,817,795,784,621,553,587,609,961,9116,9378,9937
E02004909,Royston North & Central,219,95,403,401,519,492,438,412,383,347,326,245,276,174,255,4671,4766,4985
E02004910,"Royston South, West & East",518,232,757,732,881,919,920,819,813,743,643,599,740,541,655,9762,9994,10512
E02004911,Letchworth Grange,350,160,448,411,481,514,514,448,449,505,382,362,280,232,411,5437,5597,5947
E02004912,Baldock,533,278,776,693,740,695,783,822,825,871,731,529,475,388,599,8927,9205,9738
E02004913,"Great Ashby, Ashwell & Barley",845,391,1038,788,944,1065,1174,1236,1233,1198,959,794,705,555,690,12379,12770,13615
E02004914,Letchworth East,374,208,550,500,664,700,656,601,589,548,421,358,368,244,365,6564,6772,7146
E02004915,Letchworth Wilbury,287,143,456,348,409,432,408,413,478,410,296,250,250,208,277,4635,4778,5065
E02004916,Letchworth South West,451,202,593,405,419,467,557,592,554,586,440,393,469,382,596,6453,6655,7106
E02004917,Letchworth South East,294,149,478,330,390,396,425,412,452,493,435,341,440,317,479,5388,5537,5831
E02004918,Hitchin Bearton,358,148,513,709,879,817,765,671,607,538,402,324,253,180,295,6953,7101,7459
E02004919,Hitchin Walsworth,396,176,475,504,638,651,671,591,548,491,442,365,327,273,305,6281,6457,6853
E02004920,Hitchin Town & West,588,259,691,752,792,794,815,876,849,855,652,554,600,456,870,9556,9815,10403
E02004921,Hitchin Highbury,409,202,475,382,494,597,720,665,593,521,431,344,362,311,486,6381,6583,6992
E02004922,"Ickleford, Great Offley & Whitwell",518,280,734,455,528,589,696,750,802,922,742,577,616,489,544,8444,8724,9242
E02004923,"Knebworth, Codicote & Kimpton",467,226,646,606,657,659,677,718,796,820,827,630,627,489,761,8913,9139,9606
E02004956,Abbots Langley,453,207,684,560,624,619,635,671,716,748,548,466,471,385,495,7622,7829,8282
E02004957,Leavesden & Garston Manor,659,297,813,634,742,818,949,891,829,799,606,462,442,317,304,8606,8903,9562
E02004958,Croxley North & Sarratt,434,200,558,421,398,505,581,575,589,658,542,413,425,325,474,6464,6664,7098
E02004959,Rickmansworth North & Loudwater,387,183,524,361,358,337,483,471,509,491,436,337,353,266,580,5506,5689,6076
E02004960,Chorleywood,417,168,446,265,243,289,413,511,538,456,375,305,301,252,354,4748,4916,5333
E02004961,Croxley Green,542,271,717,466,553,668,857,830,754,716,619,469,491,328,478,7946,8217,8759
E02004962,Rickmansworth West,493,244,626,527,627,717,726,714,741,730,531,388,407,313,457,7504,7748,8241
E02004963,Oxhey Hall & Hayling,467,240,656,463,583,606,622,582,567,550,412,364,311,227,246,6189,6429,6896
E02004964,"Mill End, Heronsgate & Maple Cross",330,122,401,350,409,466,434,429,452,410,363,255,248,211,235,4663,4785,5115
E02004965,Carpenders Park,341,178,522,429,464,528,594,509,507,492,430,347,404,398,505,6129,6307,6648
E02004966,Moor Park & Batchworth,317,202,549,572,631,775,831,825,790,695,530,488,483,369,537,8075,8277,8594
E02004967,South Oxhey,400,214,583,612,707,734,718,617,575,512,417,320,226,152,243,6416,6630,7030
E02004968,Woodside & Leavesden Green,440,210,631,479,574,648,592,584,601,493,412,307,304,229,285,6139,6349,6789
E02004969,Stanborough,431,191,630,509,564,554,551,597,591,573,463,326,261,233,334,6186,6377,6808
E02004970,Garston,506,208,693,554,699,743,753,618,625,557,452,361,323,247,370,6995,7203,7709
E02004971,Leggatts,527,244,756,636,719,808,806,707,559,541,413,301,240,211,285,6982,7226,7753
E02004972,Tudor,320,139,440,367,477,507,604,481,451,402,381,345,272,215,261,5203,5342,5662
E02004973,North Watford,391,189,692,869,1106,1064,834,714,613,505,364,257,209,89,146,7462,7651,8042
E02004974,Nascot Wood,404,193,629,662,779,959,853,700,630,566,460,341,415,312,572,7878,8071,8475
E02004975,Cassiobury,523,246,649,534,536,637,655,720,675,588,438,361,365,303,385,6846,7092,7615
E02004976,Central Watford,373,153,927,1399,1819,1631,1291,942,745,585,453,286,236,164,235,10713,10866,11239
E02004977,West Watford,561,254,850,1053,1195,1169,980,905,742,558,412,269,197,149,186,8665,8919,9480
E02004978,Holywell,619,291,932,926,1189,1127,1114,823,719,591,414,359,253,180,347,8974,9265,9884
E02004979,Oxhey,379,170,559,538,636,630,599,553,588,504,426,381,338,247,259,6258,6428,6807
E02005503,"Bawdeswell, Swanton Morley & North Elmham",352,160,681,552,521,476,417,497,539,587,534,549,566,430,540,6889,7049,7401
E02005504,"Whissonsett, Litcham & Narborough",412,157,534,414,437,404,420,539,749,804,770,685,749,630,691,7826,7983,8395
E02005505,Dereham North & Neatherd,373,176,554,438,449,398,444,452,576,546,455,447,482,425,666,6332,6508,6881
E02005506,"Dereham West, Necton & Gressenhall",267,141,448,364,379,363,339,438,528,594,509,499,551,400,503,5915,6056,6323
E02005507,Dereham Central & Toftwood,533,260,881,728,744,654,742,727,855,778,655,685,720,644,788,9601,9861,10394
E02005508,"Hockering, Mattishall & Cranworth",313,137,450,352,358,371,410,430,573,668,570,566,601,455,457,6261,6398,6711
E02005509,Swaffham,322,161,502,472,499,480,416,481,513,583,648,648,710,614,907,7473,7634,7956
E02005510,"Shipdham, Bradenham & Saham Toney",272,119,434,344,366,324,337,384,533,646,587,592,653,576,564,6340,6459,6731
E02005511,Watton,287,142,611,606,705,524,494,491,620,657,592,559,664,574,770,7867,8009,8296
E02005512,"Wayland, Ellingham & Great Hockham",421,178,764,784,778,727,685,674,749,776,717,599,634,403,420,8710,8888,9309
E02005513,Attleborough,433,189,760,756,791,748,643,660,759,757,627,581,668,529,676,8955,9144,9577
E02005514,"Mundford, Weeting & Forest",291,112,337,291,330,363,318,416,525,631,576,477,557,414,422,5657,5769,6060
E02005515,Buckenhams & Snetterton,338,162,398,337,384,315,378,421,530,566,467,439,399,329,401,5364,5526,5864
E02005516,"East Harling, Garboldisham & Kenninghall",285,136,399,354,370,410,387,412,522,613,509,520,586,380,478,5940,6076,6361
E02005517,Thetford North,434,200,647,544,643,599,562,454,461,427,326,244,226,155,185,5473,5673,6107
E02005518,Thetford Central & East,490,255,859,846,1028,945,847,767,815,818,648,527,507,373,579,9559,9814,10304
E02005519,Thetford South,525,239,784,729,859,758,661,626,666,631,532,376,339,257,376,7594,7833,8358
E02005520,Aylsham,369,199,528,401,466,489,479,514,636,598,637,581,782,582,750,7443,7642,8011
E02005521,"Reepham, Cawston & Lenwade",389,211,561,394,429,423,464,556,731,777,660,626,704,473,500,7298,7509,7898
E02005522,"Coltishall, Buxton & Frettenham",262,111,328,239,281,323,345,378,423,452,422,396,396,310,380,4673,4784,5046
E02005523,"Horsford, Hainford & Hevingham",402,189,634,465,554,536,548,551,753,677,555,524,537,359,387,7080,7269,7671
E02005524,Spixworth & St Faiths,202,98,321,273,309,286,266,346,404,434,411,361,418,336,391,4556,4654,4856
E02005525,Taverham,458,237,708,558,599,547,623,701,848,792,581,555,569,479,653,8213,8450,8908
E02005526,Drayton & Thorpe Marriott,254,111,343,279,298,303,311,371,476,412,346,305,351,267,455,4517,4628,4882
E02005527,"Wroxham, Rackheath & the Plumsteads",412,195,588,489,521,527,535,619,686,695,609,513,594,484,688,7548,7743,8155
E02005528,Old Catton,370,162,561,506,529,555,574,569,606,617,533,500,575,452,596,7173,7335,7705
E02005529,Hellesdon North West,207,104,341,326,344,322,317,317,438,441,425,397,433,365,651,5117,5221,5428
E02005530,Hellesdon South East,228,114,355,324,358,394,358,371,412,435,372,302,331,317,437,4766,4880,5108
E02005531,Sprowston Central,231,100,360,302,330,342,370,339,408,407,394,317,328,260,410,4567,4667,4898
E02005532,Sprowston East,352,148,570,661,713,678,572,544,562,597,555,523,633,501,743,7852,8000,8352
E02005533,"Blofield, Lingwood & Upton",442,205,516,382,471,501,551,639,650,731,685,620,697,592,643,7678,7883,8325
E02005534,Thorpe St Andrew North,330,183,436,361,394,392,457,539,559,654,534,515,462,403,607,6313,6496,6826
E02005535,Thorpe St Andrew South & Dussindale,392,181,548,366,406,414,552,573,615,553,451,395,379,251,419,5922,6103,6495
E02005536,Brundall & Cantley,241,116,401,261,338,370,358,399,518,550,457,475,488,392,500,5507,5623,5864
E02005537,Acle & Reedham,243,129,402,292,284,329,299,342,481,502,455,410,467,370,492,5125,5254,5497
E02005538,Hemsby & Ormesby,353,183,624,440,473,415,442,543,758,876,886,891,865,702,710,8625,8808,9161
E02005539,"Fleggburgh, Rollesby & Martham",319,151,533,329,377,420,410,468,617,709,666,623,684,537,518,6891,7042,7361
E02005540,Caister on Sea,328,172,542,436,445,405,472,484,681,714,738,693,813,684,833,7940,8112,8440
E02005541,Yarmouth North,343,157,488,389,402,401,349,418,436,453,406,372,366,329,422,5231,5388,5731
E02005542,Yarmouth Central & Northgate,384,176,743,772,785,714,589,584,660,611,458,350,337,217,272,7092,7268,7652
E02005543,Yarmouth Parade,636,293,1058,1002,1038,994,844,846,837,775,545,409,307,238,276,9169,9462,10098
E02005544,Southtown & Cobholm,436,231,680,665,643,606,534,480,565,506,402,319,277,210,209,6096,6327,6763
E02005545,Bradwell North,284,126,442,337,353,382,388,400,458,478,443,469,546,403,503,5602,5728,6012
E02005546,Gorleston North,340,179,664,612,600,512,451,477,585,572,512,453,452,341,417,6648,6827,7167
E02005547,Gorleston South & Beach,418,228,642,503,595,536,582,598,619,649,590,524,516,444,611,7409,7637,8055
E02005548,Gorleston West,400,198,593,498,626,516,438,441,499,507,418,402,404,332,510,6184,6382,6782
E02005549,Belton,241,100,346,290,305,271,284,351,401,528,455,474,467,390,342,4904,5004,5245
E02005550,Bradwell South & Hopton,339,166,558,533,529,473,444,517,563,610,526,477,538,410,562,6740,6906,7245
E02005551,Hunstanton,150,72,251,193,166,174,195,209,329,411,446,495,634,489,697,4689,4761,4911
E02005552,"Brancaster, Burnham Market & Docking",266,116,320,264,264,293,324,351,502,524,533,561,623,508,609,5676,5792,6058
E02005553,Heacham & Snettisham,297,125,416,326,285,324,354,443,587,714,690,788,1027,837,958,7749,7874,8171
E02005554,"Dersingham, Sandringham & Massingham",230,104,389,281,283,292,303,351,462,513,555,590,707,603,718,6047,6151,6381
E02005555,Wootton,326,165,444,274,332,380,404,406,502,556,482,522,544,428,552,5826,5991,6317
E02005556,Gaywood North Bank,330,150,520,491,537,521,467,511,542,558,536,424,438,380,545,6470,6620,6950
E02005557,North Lynn,422,178,687,659,786,697,542,504,524,463,339,246,207,160,199,6013,6191,6613
E02005558,Terrington & Clenchwarton,318,154,484,436,391,400,423,434,567,563,570,522,544,438,515,6287,6441,6759
E02005559,Gaywood Chase & Old Gaywood,369,213,618,521,630,655,520,539,598,515,460,379,349,244,421,6449,6662,7031
E02005560,Fairstead & Springwood,538,268,703,754,1008,844,697,664,594,535,417,368,309,248,296,7437,7705,8243
E02005561,"Town, South Lynn & West Lynn",531,218,1018,1098,1286,1049,848,800,771,753,635,473,473,374,483,10061,10279,10810
E02005562,"Grimston, Gayton & East Winch",297,129,455,349,400,363,380,466,599,677,642,505,616,449,490,6391,6520,6817
E02005563,"Marshland, Walpole & Walton",409,174,599,508,511,394,432,527,635,744,635,557,549,420,489,7000,7174,7583
E02005564,"West Winch, Marham & Shouldham",352,154,848,741,762,702,532,546,625,727,676,612,616,518,633,8538,8692,9044
E02005565,"Watlington, Wiggenhall & Terrington St John",301,166,535,472,443,387,379,517,555,605,516,474,451,371,439,6144,6310,6611
E02005566,"Upwell, Delph & Emneth",454,191,711,598,594,598,536,660,832,987,833,718,693,560,641,8961,9152,9606
E02005567,Downham Market,451,190,640,611,729,661,640,631,750,714,680,685,778,720,1173,9412,9602,10053
E02005568,"Stoke Ferry, Hilgay & Wimbotsham",304,141,437,356,402,357,381,452,594,724,640,530,601,424,533,6431,6572,6876
E02005569,"Southery, Feltwell & Hockwold",346,173,533,392,402,407,446,521,644,639,606,540,524,379,446,6479,6652,6998
E02005570,Sheringham,285,138,404,242,235,284,312,373,417,532,582,592,728,641,892,6234,6372,6657
E02005571,Wells & Blakeney,223,108,297,247,241,265,251,332,420,456,531,524,552,463,667,5246,5354,5577
E02005572,Cromer,267,113,430,318,382,362,365,389,507,545,653,640,780,596,805,6772,6885,7152
E02005573,Holt & Weybourne,338,248,444,211,192,207,213,286,349,381,456,476,613,539,756,5123,5371,5709
E02005574,"Overstrand, Roughton & the Runtons",230,113,341,279,298,320,304,346,491,636,690,647,674,501,615,6142,6255,6485
E02005575,"Beeston Regis, Saxthorpe & Aldborough",303,149,388,281,281,322,316,387,499,647,661,627,691,464,537,6101,6250,6553
E02005576,"Mundesley, Trunch & Bacton",254,125,366,257,273,259,261,335,481,571,627,585,684,535,610,5844,5969,6223
E02005577,"Melton Constable, Briston & Little Snoring",227,126,340,306,291,285,282,340,473,488,503,475,533,375,431,5122,5248,5475
E02005578,Walsingham & Raynham,236,136,418,310,329,341,335,354,475,520,453,390,423,339,349,5036,5172,5408
E02005579,North Walsham,513,263,904,791,733,694,595,719,938,952,888,829,999,801,1225,11068,11331,11844
E02005580,Fakenham,291,150,500,510,510,473,403,449,509,551,550,556,623,506,750,6890,7040,7331
E02005581,"Felmingham, Worstead & Happisburgh",294,110,469,524,568,494,527,539,652,727,786,644,623,445,416,7414,7524,7818
E02005582,Stalham & Sea Palling,239,101,401,302,354,316,326,392,485,575,572,571,574,436,555,5859,5960,6199
E02005583,"Hoveton, Horning & Potter Heigham",282,144,455,368,347,335,371,490,600,766,802,825,898,710,922,7889,8033,8315
E02005584,Catton Grove & Airport,545,229,924,949,1086,1123,890,769,793,724,616,499,434,324,378,9509,9738,10283
E02005585,Mile Cross,649,309,1040,1006,1136,1090,932,827,796,686,505,402,364,282,346,9412,9721,10370
E02005586,New Catton & Mousehold North,340,190,801,1122,1350,1168,960,810,723,638,428,382,335,210,254,9181,9371,9711
E02005587,Heartsease & Pilling Park,572,232,890,857,1072,908,805,719,724,687,619,425,414,366,657,9143,9375,9947
E02005588,Bowthorpe & West Earlham,657,298,2288,1213,1116,1052,864,770,699,615,526,514,502,330,439,10928,11226,11883
E02005589,Earlham,741,288,1894,1164,1102,973,860,738,752,660,522,427,427,299,378,10196,10484,11225
E02005590,City Centre West,261,140,2268,1485,1432,1136,827,779,727,650,587,549,487,393,456,11776,11916,12177
E02005592,Earlham Road & College Road,325,158,1436,1057,914,763,733,623,597,555,412,437,402,212,286,8427,8585,8910
E02005593,University & Avenues,374,238,7803,1958,814,528,448,387,386,355,295,272,261,191,344,14042,14280,14654
E02005594,Town Close,366,165,1197,1140,1150,1024,880,746,732,704,605,578,592,360,533,10241,10406,10772
E02005595,Eaton,456,234,902,523,529,518,617,610,632,639,601,578,632,565,856,8202,8436,8892
E02005596,Lakenham & Tuckswood,500,247,827,796,960,809,753,682,645,642,483,454,475,333,487,8346,8593,9093
E02006907,City Centre East,124,57,882,1143,1059,861,628,426,449,376,350,266,247,217,288,7192,7249,7373
E02006908,Thorpe Hamlet & Mousehold South,159,71,426,567,606,554,465,422,358,372,322,271,247,158,179,4947,5018,5177
E02005597,Costessey & Queens Hills,812,342,1054,1111,1416,1410,1231,1084,1059,1004,861,737,823,641,838,13269,13611,14423
E02005598,"Cringleford, Little Melton & Easton",470,223,603,585,665,797,795,771,673,700,601,501,566,450,679,8386,8609,9079
E02005599,Hethersett,355,149,434,460,469,497,532,452,489,440,368,384,447,377,496,5845,5994,6349
E02005600,"Hingham, Morley & Barnham Broom",671,330,488,293,267,281,294,406,501,503,483,407,456,362,422,5163,5493,6164
E02005601,Wymondham West,185,102,340,247,291,294,310,327,428,462,398,352,434,415,529,4827,4929,5114
E02005602,"Trowse, Poringland & Stoke Holy Cross",536,252,747,691,787,777,774,829,948,993,912,768,872,686,913,10697,10949,11485
E02005603,Wymondham East & Spooner Row,751,334,906,842,989,950,930,978,968,832,645,540,588,453,572,10193,10527,11278
E02005604,"Loddon, Surlingham & Alpington",380,243,572,457,465,472,489,540,692,732,623,616,627,492,667,7444,7687,8067
E02005605,"Mulbarton, Tasburgh & Saxlingham Nethergate",497,209,624,518,588,672,686,755,755,795,819,753,685,579,676,8905,9114,9611
E02005606,"Thurlton, Haddiscoe & Geldeston",266,132,411,254,263,274,300,410,473,564,470,435,431,349,343,4977,5109,5375
E02005607,"Long Stratton, Carlton Rode & Tibenham",527,271,732,563,618,674,650,783,901,966,829,719,782,627,642,9486,9757,10284
E02005608,"Hempnall, Ditchingham & Wortwell",296,166,490,344,338,386,401,459,653,668,656,590,653,474,566,6678,6844,7140
E02005609,Harleston & Pulham,334,146,409,365,412,433,404,443,525,559,524,482,621,482,625,6284,6430,6764
E02005610,"Scole, Dickleburgh & Bressingham",336,155,476,360,386,392,393,511,687,700,717,632,682,479,560,6975,7130,7466
E02005611,Diss & Roydon,401,214,742,701,730,764,697,696,761,791,723,662,699,616,942,9524,9738,10139
E02006227,"Lavenham, Bildeston & Brettenham",243,120,351,256,294,297,283,328,499,611,557,561,606,439,514,5596,5716,5959
E02006228,Glemsford & Lawshall,260,110,374,330,361,313,330,389,439,507,470,423,464,344,350,5094,5204,5464
E02006229,North Sudbury & Long Melford,251,128,352,271,303,327,325,387,465,445,447,455,553,452,525,5307,5435,5686
E02006230,Hadleigh,568,290,751,514,588,592,649,737,786,804,723,715,779,679,915,9232,9522,10090
E02006231,"Sproughton, Washbrook & Hintlesham",401,202,583,511,512,500,577,600,686,687,575,542,494,370,457,7094,7296,7697
E02006232,"Acton, Great Waldingfield & Bures",249,137,370,269,311,325,366,350,441,511,451,458,495,375,371,5093,5230,5479
E02006233,Sudbury,436,257,805,737,806,690,686,737,922,839,705,612,707,647,978,9871,10128,10564
E02006234,Great Cornard,543,273,780,616,708,629,623,690,748,704,520,440,559,454,499,7970,8243,8786
E02006235,"Leavenheath, Nayland & Boxford",391,208,478,346,369,430,532,539,677,736,681,558,666,526,615,7153,7361,7752
E02006236,"East Bergholt, Brantham & Capel St Mary",484,253,719,433,469,549,626,660,844,883,734,733,836,709,785,8980,9233,9717
E02006237,Shotley Peninsula,469,281,472,315,384,369,407,436,587,654,631,518,528,417,608,6326,6607,7076
E02006245,Whitton,480,214,641,521,600,599,515,513,541,569,486,433,407,388,553,6766,6980,7460
E02006246,Castle Hill,321,172,492,417,522,491,471,465,563,525,493,451,436,309,479,6114,6286,6607
E02006247,Whitehouse,475,215,739,758,792,701,666,612,615,562,467,357,374,259,305,7207,7422,7897
E02006248,Rushmere,559,268,631,448,555,606,623,671,688,581,459,395,407,318,428,6810,7078,7637
E02006249,Christchurch Park,483,303,673,571,630,654,715,665,696,639,552,493,463,343,541,7635,7938,8421
E02006250,Westgate,567,279,1141,1104,1342,1215,1060,909,825,659,512,349,293,196,196,9801,10080,10647
E02006251,Ipswich Central,502,249,1149,1329,1511,1423,1166,882,821,685,541,369,310,163,246,10595,10844,11346
E02006252,California,528,267,687,737,898,889,784,727,641,644,486,394,363,296,459,8005,8272,8800
E02006253,Broke Hall,378,162,498,393,450,497,480,505,502,581,461,470,502,392,613,6344,6506,6884
E02006254,Gipping & Chantry Park,566,254,855,812,997,1030,887,702,663,599,477,420,327,232,394,8395,8649,9215
E02006255,Holywells,388,163,819,732,934,886,777,613,569,534,450,373,344,200,305,7536,7699,8087
E02006256,"Maidenhall, Stoke & Port",546,267,897,921,934,941,860,686,659,616,480,386,365,247,341,8333,8600,9146
E02006257,Belstead Hills,334,157,431,363,487,481,465,393,432,459,442,380,359,294,477,5463,5620,5954
E02006258,Priory Heath,610,284,870,704,730,788,806,690,657,617,510,384,375,245,381,7757,8041,8651
E02006259,Stoke Park,370,168,568,515,540,522,449,404,475,443,440,440,431,310,326,5863,6031,6401
E02006260,"Gainsborough, Greenwich & Orwell",523,242,661,577,724,741,617,569,618,575,424,438,381,264,347,6936,7178,7701
E02006261,"Eye, Palgrave & Occold",362,187,534,368,384,414,447,485,600,717,668,617,731,537,594,7096,7283,7645
E02006262,"Rickinghall, Walsham le Willows & Gislingham",416,216,591,418,399,442,440,570,769,851,758,673,742,586,552,7791,8007,8423
E02006263,"Fressingfield, Laxfield & Worlingworth",304,191,436,303,325,337,328,461,623,667,678,568,624,527,552,6429,6620,6924
E02006264,"Thurston, Badwell Ash & Elmswell North",449,213,621,485,580,544,539,588,650,811,626,577,633,441,546,7641,7854,8303
E02006265,"Stowupland, Mendlesham & Bacton",310,152,473,382,420,433,401,438,506,618,583,525,527,437,530,6273,6425,6735
E02006266,"Elmswell South, Haughley, Beyton & Felsham",432,209,601,445,502,505,512,554,711,827,738,718,767,584,698,8162,8371,8803
E02006267,"Debenham, Stonham & Coddenham",448,208,574,383,328,384,481,609,762,810,728,673,679,420,502,7333,7541,7989
E02006268,Stowmarket West,300,142,515,370,408,378,372,374,447,482,396,384,421,324,497,5368,5510,5810
E02006269,"Stowmarket Outer, Finborough & Battisford",336,176,551,481,511,441,442,503,573,602,576,488,480,368,493,6509,6685,7021
E02006270,Stowmarket East & Needham Market North,624,314,971,970,1079,1024,935,929,949,870,708,538,520,385,502,10380,10694,11318
E02006271,Needham Market South & Great Blakenham,343,177,861,956,945,781,593,556,632,622,600,535,573,473,580,8707,8884,9227
E02006272,Claydon & Bramford,323,181,461,304,412,374,465,470,584,582,526,512,603,460,580,6333,6514,6837
E02004924,Harpenden North,625,255,573,366,392,449,737,778,704,594,429,294,319,275,336,6246,6501,7126
E02004925,Harpenden East,695,302,519,349,378,550,726,797,716,568,443,329,268,231,374,6248,6550,7245
E02004926,Harpenden Town,564,199,518,417,425,551,698,783,735,634,489,335,382,346,595,6908,7107,7671
E02004927,Wheathampstead,399,183,461,256,302,378,473,563,549,473,419,352,368,312,429,5335,5518,5917
E02004928,Harpenden Common,383,210,433,339,343,428,536,584,602,542,507,368,384,312,411,5789,5999,6382
E02004929,Redbourn,382,187,422,295,356,406,493,503,515,496,401,339,402,358,459,5445,5632,6014
E02004930,Jersey Farm & Sandridge,432,206,481,396,434,492,584,580,617,544,464,345,293,270,363,5863,6069,6501
E02004931,Marshalswick,532,208,518,363,354,553,641,644,582,511,392,350,304,214,358,5784,5992,6524
E02004932,Townsend & New Greens,516,237,598,440,559,628,742,701,603,563,408,327,315,232,291,6407,6644,7160
E02004933,Bernards Heath,481,235,499,339,367,448,623,615,614,568,401,329,284,224,312,5623,5858,6339
E02004934,Clarence Park,385,187,513,693,896,937,797,696,587,546,365,281,255,164,278,7008,7195,7580
E02004935,St Albans Central,290,117,463,1105,1346,1135,986,748,650,521,384,314,222,171,278,8323,8440,8730
E02004936,Longacres,462,207,450,395,448,549,703,678,569,474,281,245,212,165,181,5350,5557,6019
E02004937,Verulam Park,408,177,412,344,411,486,635,637,607,562,419,416,438,383,595,6345,6522,6930
E02004938,Colney Heath & Tyttenhanger,418,192,524,329,382,420,507,582,621,466,376,282,273,194,267,5223,5415,5833
E02004939,The Camp & Cunningham,433,179,419,406,512,601,614,612,489,469,358,260,290,206,408,5644,5823,6256
E02004940,Cottonmill & Sopwell,466,198,546,497,681,725,777,641,620,473,387,296,273,194,286,6396,6594,7060
E02004941,London Colney,538,267,803,664,730,790,820,820,803,722,619,488,455,300,368,8382,8649,9187
E02004942,How Wood & Park Street,331,163,448,356,399,430,455,495,493,472,428,359,365,310,400,5410,5573,5904
E02004943,Bricket Wood & Chiswell Green,441,208,594,471,452,490,570,641,636,708,583,489,541,453,611,7239,7447,7888
E02004980,"Woolmer Green, Oaklands & Digswell",336,146,419,286,283,327,407,461,539,561,496,359,397,325,427,5287,5433,5769
E02004981,Welwyn & Hatfield Garden Village,452,203,593,448,536,612,698,647,680,587,485,372,384,299,452,6793,6996,7448
E02004982,Knightsfield,360,181,408,299,344,392,440,438,475,518,405,255,289,246,353,4862,5043,5403
E02004983,Haldens,314,132,414,390,473,488,482,423,428,429,356,334,257,209,314,4997,5129,5443
E02004984,Panshanger,251,106,412,451,515,559,486,413,407,476,514,396,309,209,319,5466,5572,5823
E02004985,Welwyn Garden City Central & Handside,328,168,466,375,418,470,505,482,518,562,450,370,396,364,633,6009,6177,6505
E02004986,Peartree,502,223,733,880,907,889,710,606,647,530,383,293,213,146,182,7119,7342,7844
E02004987,Hall Grove,448,180,540,480,646,676,611,571,609,480,409,288,259,179,312,6060,6240,6688
E02004988,Hollybush,433,198,612,556,662,671,716,568,563,528,380,299,262,205,275,6297,6495,6928
E02004989,Hatfield North & West,495,231,2752,1534,1147,982,889,719,684,607,417,325,320,234,291,10901,11132,11627
E02004990,Hatfield East,301,156,635,662,720,733,633,492,488,457,393,323,296,226,376,6434,6590,6891
E02004991,Hatfield Town,365,131,1190,1005,954,905,676,508,471,451,384,234,167,132,247,7324,7455,7820
E02004992,Hatfield South,429,204,3733,1645,1058,822,672,515,469,426,348,207,187,144,284,10510,10714,11143
E02004993,Welham Green,223,106,530,453,452,386,416,349,388,431,394,317,277,231,300,4924,5030,5253
E02004994,Brookmans Park,365,204,569,354,341,337,380,455,489,518,469,338,331,285,391,5257,5461,5826
E02004995,Cuffley & Northaw,252,142,421,271,268,306,340,355,431,515,377,365,346,277,490,4762,4904,5156
E02004878,Buntingford & Great Hormead,431,206,600,503,644,571,572,594,706,685,567,484,533,397,467,7323,7529,7960
E02004879,"Datchworth, Walkern & Cottered",353,200,571,421,391,447,511,567,675,785,637,507,560,372,463,6907,7107,7460
E02004880,Bishop's Stortford West & Braughing,649,302,836,637,720,746,773,808,905,938,681,521,483,347,430,8825,9127,9776
E02004881,Bishop's Stortford North,345,175,556,687,671,563,560,580,518,414,354,293,328,194,484,6202,6377,6722
E02004882,Bishop's Stortford East,628,342,830,767,718,730,746,745,693,594,479,325,365,243,387,7622,7964,8592
E02004883,Puckeridge & Thundridge,421,211,471,300,397,371,408,420,513,514,438,343,346,291,302,5114,5325,5746
E02004884,Bishop's Stortford Central,466,231,872,985,1039,933,840,789,776,710,584,478,389,258,418,9071,9302,9768
E02004885,Bishop's Stortford South,535,254,732,534,512,535,662,733,830,735,602,391,353,288,323,7230,7484,8019
E02004886,Much Hadham & Hunsdon,333,152,460,327,369,481,504,456,563,545,449,391,376,252,344,5517,5669,6002
E02004887,"Watton-at-Stone, Bramfield & Bayford",374,201,531,371,431,449,476,556,650,681,571,481,524,331,395,6447,6648,7022
E02004888,Sawbridgeworth,409,200,621,458,508,579,655,691,675,655,608,552,566,415,558,7541,7741,8150
E02004889,Ware East,594,236,796,699,905,887,920,872,863,761,586,455,494,395,793,9426,9662,10256
E02004890,Ware West,347,183,534,594,722,617,614,637,638,666,574,457,465,304,368,7190,7373,7720
E02004891,Hertford Bengeo,395,183,440,374,501,559,615,638,634,599,461,429,435,333,476,6494,6677,7072
E02004892,Hertford West,279,138,407,388,455,480,458,411,451,435,311,259,198,198,239,4690,4828,5107
E02004893,Hertford Foxholes,360,162,449,394,415,444,457,520,512,470,300,208,190,153,137,4649,4811,5171
E02004894,Hertford South,422,186,583,719,793,802,787,801,714,653,511,434,408,329,527,8061,8247,8669
E02004895,Hertford Heath & Stanstead St Margarets,745,480,774,589,548,614,591,717,735,745,621,512,504,419,446,7815,8295,9040
E02004944,St Nicholas,459,229,731,690,774,743,668,607,583,489,381,275,258,173,177,6549,6778,7237
E02004945,Woodfield & Old Town,615,285,872,929,1131,1023,945,919,887,888,703,561,533,404,559,10354,10639,11254
E02004946,Martins Wood,339,139,541,473,504,552,476,412,487,557,395,274,252,190,277,5390,5529,5868
E02004947,Chells North,269,129,449,451,441,460,461,444,523,607,462,393,286,220,249,5446,5575,5844
E02004948,Symonds Green,245,115,429,436,599,516,400,417,411,400,362,353,317,195,242,5077,5192,5437
E02004949,Pin Green,392,193,663,674,875,768,654,573,657,621,481,369,364,318,505,7522,7715,8107
E02004950,Chells South,383,176,530,469,598,574,503,435,511,541,395,260,243,195,310,5564,5740,6123
E02004951,Bedwell,392,177,759,779,912,846,638,544,546,552,415,264,252,185,313,7005,7182,7574
E02004952,Poplars,335,163,507,491,529,525,477,417,522,569,473,319,264,169,318,5580,5743,6078
E02004953,Shephall,387,166,526,477,577,564,512,434,476,489,381,232,202,177,248,5295,5461,5848
E02004954,Roebuck,352,167,533,488,655,615,552,422,533,495,439,312,274,211,279,5808,5975,6327
E02004955,Broadwater & Bragbury End,317,163,398,399,460,470,453,352,416,482,417,328,290,171,273,4909,5072,5389
E02006287,"Yoxford, Wenhaston & Walberswick",210,115,296,229,252,280,265,324,400,568,646,648,641,438,529,5516,5631,5841
E02006288,Framlingham & Hacheston,526,329,761,425,448,405,483,660,753,888,736,702,782,582,749,8374,8703,9229
E02006289,Saxmundham & Coldfair Green,433,211,570,509,558,474,463,558,698,836,784,692,799,625,738,8304,8515,8948
E02006290,Leiston & Aldeburgh,339,164,536,453,473,443,449,436,567,605,682,606,665,549,758,7222,7386,7725
E02006291,Wickham Market & Melton,321,155,517,394,408,371,418,446,544,661,623,590,681,485,592,6730,6885,7206
E02006292,"Westerfield, Grundisburgh & Bredfield",377,180,426,268,300,270,378,505,623,616,541,519,521,417,443,5827,6007,6384
E02006293,"Rendlesham, Orford & Hollesley",499,251,955,749,783,719,750,714,913,878,767,770,715,480,616,9809,10060,10559
E02006294,Woodbridge,364,209,557,352,377,413,439,477,604,663,557,517,649,582,1026,7213,7422,7786
E02006295,Kesgrave West & Rushmere,461,259,688,472,491,596,610,618,691,654,665,507,626,519,777,7914,8173,8634
E02006296,Kesgrave East & Martlesham,727,340,888,665,715,822,935,971,996,932,875,759,849,591,726,10724,11064,11791
E02006297,"Bixley, Warren Heath & Nacton",402,215,584,369,337,382,447,552,678,790,660,536,614,449,672,7070,7285,7687
E02006298,Trimley & Kirton,395,177,598,521,551,488,556,620,701,729,772,640,714,448,466,7804,7981,8376
E02006299,Felixstowe East,282,148,464,280,280,351,363,419,557,703,673,756,845,766,1051,7508,7656,7938
E02006300,Felixstowe West,402,204,602,550,613,523,472,535,591,639,548,446,436,360,383,6698,6902,7304
E02006301,Felixstowe Seafront,237,146,416,373,385,384,391,488,503,512,469,428,512,354,558,5773,5919,6156
E02006302,"Gunton East, Corton & Somerleyton",280,122,397,315,275,325,317,409,522,562,572,544,624,487,594,5943,6065,6345
E02006303,Gunton West,512,239,675,505,562,563,494,523,593,537,426,375,376,343,376,6348,6587,7099
E02006304,Oulton,322,134,489,481,490,456,380,422,548,596,565,564,700,598,709,6998,7132,7454
E02006305,Lowestoft Central,530,265,902,819,1039,845,743,633,767,699,563,402,368,288,311,8379,8644,9174
E02006306,Normanston & Oulton Broad East,349,138,513,440,540,507,416,382,492,531,513,494,551,426,514,6319,6457,6806
E02006307,Oulton Broad West,281,155,449,341,342,349,383,445,500,568,539,534,722,550,714,6436,6591,6872
E02006308,Lowestoft Harbour & Kirkley,347,169,639,593,626,639,545,551,597,612,545,430,428,259,368,6832,7001,7348
E02006309,Pakefield North,335,162,439,352,388,390,378,358,455,472,481,438,529,396,619,5695,5857,6192
E02006310,Carlton Colville,409,195,573,471,523,519,516,501,625,658,493,409,453,391,493,6625,6820,7229
E02006311,Beccles,388,188,510,422,461,463,449,446,614,556,568,559,687,560,785,7080,7268,7656
E02006312,Worlingham & Barnby,391,169,603,432,423,398,437,577,675,699,618,649,659,536,599,7305,7474,7865
E02006313,Pakefield South & Kessingland,414,205,641,477,541,512,438,592,690,793,782,705,880,702,804,8557,8762,9176
E02006314,Bungay & the Saints,284,118,471,374,395,391,387,427,549,529,561,558,572,402,602,6218,6336,6620
E02006315,"Southwold, Reydon & Wrentham",219,117,429,230,235,261,260,253,385,491,526,545,535,453,590,5193,5310,5529
E02006316,Halesworth & Wangford,255,110,398,373,382,352,311,349,447,539,582,549,629,529,750,6190,6300,6555
E02006238,Brandon,354,171,600,578,641,674,608,617,692,688,661,609,638,525,665,8196,8367,8721
E02006239,Lakenheath,198,94,299,312,350,308,290,296,321,404,302,272,335,244,312,4045,4139,4337
E02006240,"Beck Row, Eriswell & Barton Mills",337,165,497,547,620,583,475,477,581,621,566,465,444,280,316,6472,6637,6974
E02006241,Mildenhall,358,192,601,491,497,543,611,536,577,595,519,455,496,375,544,6840,7032,7390
E02006242,"Red Lodge, Icklingham & Moulton",401,195,597,640,882,836,692,634,714,606,503,413,441,306,336,7600,7795,8196
E02006243,"North Newmarket, Studlands & Exning",378,160,647,717,927,903,815,664,717,673,562,429,431,328,406,8219,8379,8757
E02006273,Stanton & Barningham,279,157,438,295,293,315,300,360,529,594,542,479,555,438,500,5638,5795,6074
E02006274,"Ixworth, Honington & Barnham",265,161,682,472,525,438,426,409,491,503,415,326,371,298,397,5753,5914,6179
E02006275,Howard Estate & Northgate,413,191,626,521,507,532,518,484,555,526,399,299,312,258,323,5860,6051,6464
E02006276,"Fornham, Great Barton & Rougham",351,176,502,408,439,469,447,518,599,584,514,523,563,464,694,6724,6900,7251
E02006277,Moreton Hall,431,198,510,467,502,537,661,607,619,515,459,331,336,211,270,6025,6223,6654
E02006278,Bury St Edmunds Central,269,164,598,617,740,620,556,541,618,605,524,435,444,387,570,7255,7419,7688
E02006279,Bury St Edmunds West,333,191,585,440,538,500,506,561,680,657,575,512,635,504,691,7384,7575,7908
E02006280,"Barrow, Chedburgh & Sicklesmere",645,367,708,414,445,489,554,649,791,802,632,653,714,605,752,8208,8575,9220
E02006281,Eastgate & Southgate,343,146,471,519,594,484,490,531,590,585,501,519,644,603,916,7447,7593,7936
E02006282,"Clare, Cavendish & Wickhambrook",286,119,356,265,264,284,315,388,509,582,514,502,571,479,543,5572,5691,5977
E02006283,"Kedington, Hundon & Withersfield",332,163,602,669,732,590,578,549,594,595,557,457,494,428,401,7246,7409,7741
E02006284,Haverhill North,387,194,571,542,599,576,518,520,580,509,455,390,396,315,386,6357,6551,6938
E02006285,Haverhill West,463,214,555,559,604,571,554,590,639,581,384,286,270,239,271,6103,6317,6780
E02006286,Haverhill East & South,618,292,866,802,984,897,868,838,860,766,591,502,594,414,485,9467,9759,10377
E02006826,South Newmarket & Racecourse,380,161,765,828,1010,969,881,649,665,670,603,450,480,342,588,8900,9061,9441
E02000001,City of London,193,115,1704,1770,1541,1132,814,737,686,628,503,401,345,240,293,10794,10909,11102
E02000002,Marks Gate,573,276,676,552,689,711,651,571,542,454,317,237,201,187,311,6099,6375,6948
E02000003,Chadwell Heath East,658,331,1086,922,1098,1114,980,784,793,677,587,403,334,246,359,9383,9714,10372
E02000004,Eastbrookend,320,170,589,548,557,522,452,439,482,452,416,288,240,190,328,5503,5673,5993
E02000005,Becontree Heath,821,347,1104,784,997,1066,963,830,796,657,435,295,231,168,235,8561,8908,9729
E02000007,Central Park & Frizlands Lane,793,306,940,770,911,865,838,743,682,627,427,326,281,179,287,7876,8182,8975
E02000008,Becontree East,1006,412,1191,899,1121,1274,1192,1104,1008,877,590,440,324,216,308,10544,10956,11962
E02000009,Becontree West,921,413,1228,1081,1294,1356,1184,1093,850,736,513,379,241,159,218,10332,10745,11666
E02000010,Dagenham North,702,306,956,733,893,901,824,751,729,658,490,322,204,157,227,7845,8151,8853
E02000011,Dagenham Eastbrook,427,211,715,575,684,638,563,536,518,422,325,255,214,187,297,5929,6140,6567
E02000012,Longbridge & Barking Park,734,359,1227,1040,985,1084,954,851,771,624,551,371,280,193,317,9248,9607,10341
E02000013,Becontree South,675,290,861,722,885,877,829,774,648,568,435,313,255,159,201,7527,7817,8492
E02000014,Dagenham Central,673,315,969,803,931,978,891,857,743,654,501,344,317,213,267,8468,8783,9456
E02000015,Old Dagenham Park & Village,619,270,776,688,793,768,689,643,629,501,371,266,223,140,185,6672,6942,7561
E02000016,Barking Central,727,342,1049,1183,1676,1682,1200,851,721,515,322,195,129,73,70,9666,10008,10735
E02000017,Barking East,581,252,1122,1024,1272,1292,1083,855,716,550,469,360,210,140,212,9305,9557,10138
E02000018,Mayesbrook Park & Rippleside,699,321,982,810,912,953,934,763,640,582,434,294,222,135,205,7866,8187,8886
E02000019,Goresbrook & Scrattons Farm,766,311,928,737,807,863,849,778,750,554,423,315,251,165,191,7611,7922,8688
E02000020,Creekmouth & Barking Riverside,902,453,1397,1267,1576,1531,1375,1168,947,770,522,377,265,185,265,11645,12098,13000
E02000021,Rylands Estate & Dagenham Dock,685,289,801,676,796,790,751,736,635,576,420,292,222,153,233,7081,7370,8055
E02000022,Gascoigne Estate & Roding Riverside,573,259,748,775,1046,991,854,657,530,363,229,148,77,71,60,6549,6808,7381
E02000023,Thames View,622,273,817,686,832,807,757,671,616,432,316,174,148,59,90,6405,6678,7300
E02006799,Becontree North,849,370,1182,892,1068,1200,1155,917,872,679,578,398,266,211,295,9713,10083,10932
E02000024,High Barnet & Hadley,512,235,740,736,797,786,796,842,801,827,721,589,576,444,619,9274,9509,10021
E02000025,Hadley Wood,390,178,508,507,609,696,679,641,642,577,528,370,370,277,370,6774,6952,7342
E02000026,Oak Hill,343,142,507,390,517,483,520,462,480,452,439,340,333,279,345,5547,5689,6032
E02000027,Ducks Island & Underhill,563,251,791,645,692,753,748,721,750,733,529,485,433,314,419,8013,8264,8827
E02000028,New Barnet West,339,165,454,439,506,539,556,514,517,474,384,297,289,218,333,5520,5685,6024
E02000029,New Barnet Town & East Barnet,545,252,705,638,767,756,824,737,707,634,484,396,344,254,293,7539,7791,8336
E02000030,Totteridge & Barnet Gate,526,277,774,583,594,601,674,665,791,722,731,548,546,411,604,8244,8521,9047
E02000031,Oakleigh Park,403,190,588,619,744,799,785,690,617,544,488,419,402,330,583,7608,7798,8201
E02000032,Osidge,522,225,632,491,477,525,690,671,694,647,507,427,422,312,454,6949,7174,7696
E02000033,Brunswick Park Road,483,207,707,573,686,768,741,690,718,633,521,414,338,253,330,7372,7579,8062
E02000034,Whetstone East,507,219,719,733,811,842,862,723,678,637,508,440,392,309,412,8066,8285,8792
E02000035,Woodside Park,416,177,589,744,964,953,938,716,596,537,492,378,418,318,454,8097,8274,8690
E02000036,Edgware East,743,327,1100,924,1048,968,964,880,833,799,664,512,443,363,457,9955,10282,11025
E02000037,Edgware Park,721,322,1000,756,833,921,913,762,679,574,603,537,555,356,494,8983,9305,10026
E02000038,Friern Barnet,629,322,818,729,897,896,995,884,907,747,617,531,424,293,506,9244,9566,10195
E02000039,Mill Hill Park,401,187,638,620,624,633,649,583,537,538,455,314,348,250,308,6497,6684,7085
E02000040,Mill Hill East,622,340,884,657,881,950,854,698,603,557,480,405,355,302,375,8001,8341,8963
E02000041,Edgware Central,587,267,974,939,1055,1000,925,790,717,680,536,494,401,273,438,9222,9489,10076
E02000042,North Finchley,602,228,858,888,1140,1262,1215,1123,884,706,580,480,409,351,538,10434,10662,11264
E02000043,West Finchley,567,242,611,500,568,694,830,774,634,514,418,366,362,239,356,6866,7108,7675
E02000044,Mill Hill Broadway,609,258,905,829,898,903,891,795,738,644,496,344,262,198,209,8112,8370,8979
E02000045,Colney Hatch,650,271,867,836,864,1000,1101,944,844,765,572,409,374,229,289,9094,9365,10015
E02000046,Church End,301,133,516,696,897,948,850,643,551,420,348,281,255,183,265,6853,6986,7287
E02000047,Burnt Oak & Watling Park,717,362,1265,1183,1356,1322,1203,1115,1066,829,627,520,391,243,383,11503,11865,12582
E02000048,Copthall & Downage,565,293,868,808,923,951,935,863,687,697,590,490,492,388,563,9255,9548,10113
E02000049,Grahame Park,660,315,1035,976,1111,1039,881,917,738,647,456,329,247,154,162,8692,9007,9667
E02000050,Fallow Corner,595,269,785,846,966,1018,1020,928,830,675,568,439,391,296,332,9094,9363,9958
E02000051,Finchley Central,462,240,820,867,938,1007,955,732,676,660,519,446,471,421,571,9083,9323,9785
E02000052,East Finchley,512,200,612,815,1093,984,995,864,753,605,478,423,346,284,347,8599,8799,9311
E02000053,Colindale,866,393,2251,2746,2969,2440,1810,1353,1151,917,712,510,342,206,291,17698,18091,18957
E02000054,North Hendon & Sunny Hill,380,167,873,893,943,817,777,603,532,491,389,342,259,209,231,7359,7526,7906
E02000055,Hendon Central,706,316,1670,1743,1631,1419,1144,961,873,680,559,431,370,287,446,12214,12530,13236
E02000056,Hampstead Garden Suburb,563,285,788,692,645,705,756,771,739,602,498,436,512,388,587,8119,8404,8967
E02000057,Hendon Park,519,241,971,940,1010,999,745,607,454,415,368,281,247,201,277,7515,7756,8275
E02000058,Temple Fortune,647,267,971,942,1017,1051,995,840,693,624,594,480,515,442,537,9701,9968,10615
E02000059,West Hendon,513,252,1043,1249,1488,1352,1201,953,803,726,683,476,355,251,386,10966,11218,11731
E02000060,Golders Green North,969,392,1413,1262,1245,1179,1037,832,656,491,525,490,388,281,583,10382,10774,11743
E02000061,Golders Green South,441,203,791,1029,1108,1081,943,794,694,540,450,351,380,234,485,8880,9083,9524
E02000062,Brent Cross & Staples Corner,414,218,810,855,854,807,755,687,611,502,388,280,212,109,157,7027,7245,7659
E02000063,North Cricklewood,457,236,835,892,897,957,845,740,631,555,455,367,280,190,274,7918,8154,8611
E02000064,Childs Hill,333,156,683,803,790,755,679,534,508,456,340,235,226,161,223,6393,6549,6882
E02000065,Crossway Park,664,236,768,575,658,640,688,788,750,602,438,277,186,125,120,6615,6851,7515
E02000066,South Thamesmead,624,288,869,740,802,761,766,756,790,725,518,398,315,198,217,7855,8143,8767
E02000067,Belvedere & Lessness Heath,569,275,833,811,1059,915,889,705,712,657,487,381,305,201,256,8211,8486,9055
E02000068,Erith East,498,198,700,628,704,747,642,624,494,506,389,290,197,139,229,6289,6487,6985
E02000069,Erith West,339,168,533,489,553,594,506,477,442,443,400,316,271,241,339,5604,5772,6111
E02000070,Lesnes Abbey,430,183,616,482,569,590,576,517,588,595,550,422,395,319,464,6683,6866,7296
E02000071,Northumberland Heath,467,212,687,531,589,585,569,553,559,538,488,369,324,221,285,6298,6510,6977
E02000072,Slade Green & Crayford Marshes,880,394,1141,926,1089,1023,1001,962,942,822,588,377,288,182,277,9618,10012,10892
E02000073,Bostall,560,269,893,679,687,767,814,699,806,874,654,531,551,454,605,9014,9283,9843
E02000074,Lesney Farm & Colyers East,545,240,754,606,697,679,642,629,632,631,493,345,324,242,312,6986,7226,7771
E02000075,Bursted Wood,367,176,561,461,534,561,553,468,595,621,534,456,520,376,529,6769,6945,7312
E02000077,St Michael's,430,223,728,512,609,685,643,531,599,564,484,338,359,250,432,6734,6957,7387
E02000078,Barnehurst North,342,165,603,481,612,618,614,514,566,558,450,424,396,307,414,6557,6722,7064
E02000079,Bexleyheath Broadway,394,181,607,609,714,700,730,590,583,618,474,393,375,319,663,7375,7556,7950
E02000080,Welling,517,236,759,667,822,866,837,690,709,724,633,503,451,324,509,8494,8730,9247
E02000081,Barnehurst South,462,193,606,479,644,614,593,561,581,594,466,397,422,312,520,6789,6982,7444
E02000082,Falconwood,483,228,701,541,697,777,701,615,671,713,565,466,422,283,417,7569,7797,8280
E02000083,Crayford,615,332,922,856,983,941,841,804,852,737,572,410,406,317,381,9022,9354,9969
E02000084,Danson Park,555,254,766,663,783,856,848,747,796,795,685,590,577,426,544,9076,9330,9885
E02000085,Blackfen,408,201,667,542,605,609,563,502,552,565,470,381,351,303,366,6476,6677,7085
E02000086,Lamorbey,347,171,533,431,435,533,475,461,557,558,505,392,411,303,332,5926,6097,6444
E02000087,Bexley Village,367,193,591,450,530,529,560,555,650,632,513,393,413,360,589,6765,6958,7325
E02000088,Albany Park,385,194,572,472,548,538,534,528,543,587,476,386,368,364,398,6314,6508,6893
E02000089,Longlands & Halfway,401,186,597,451,517,538,537,537,563,593,483,410,392,320,515,6453,6639,7040
E02000090,Sidcup West,372,146,814,635,754,684,649,593,589,586,468,388,455,388,674,7677,7823,8195
E02000091,Sidcup East,440,204,751,584,665,671,665,649,706,663,603,504,562,452,840,8315,8519,8959
E02000092,Foots Cray Meadows,382,165,564,440,480,489,459,443,461,472,399,311,311,215,332,5376,5541,5923
E02006785,Wickham Street & East Wickham,344,161,509,432,518,572,488,445,468,463,455,314,309,227,357,5557,5718,6062
E02000093,Queensbury South,638,304,1333,1376,1488,1460,1158,966,924,713,747,608,442,341,490,12046,12350,12988
E02000094,Kingsbury East & Colindale,623,304,1145,1154,1389,1145,1009,921,836,713,600,433,307,249,367,10268,10572,11195
E02000095,Kingsbury West,500,266,1119,1144,1280,1199,1053,805,719,699,641,565,416,291,420,10351,10617,11117
E02000096,Kenton Woodcock Park,359,179,699,718,860,809,742,574,481,452,484,487,457,337,472,7572,7751,8110
E02000097,Kingsbury South,551,267,1001,971,954,951,858,740,774,698,635,468,320,267,381,9018,9285,9836
E02000098,Barnhill The Avenue,525,264,963,838,933,947,851,698,617,603,543,418,372,254,426,8463,8727,9252
E02000099,Preston Park & East Lane,465,241,958,1031,1168,1058,801,700,645,564,478,355,248,174,309,8489,8730,9195
E02000100,Northwick Park,344,189,943,970,986,896,674,566,592,548,544,464,372,340,417,8312,8501,8845
E02000101,Forty Lane,647,323,1137,1044,1193,1200,1064,892,800,762,529,437,357,276,389,10080,10403,11050
E02000102,Welsh Harp,621,268,988,813,832,697,797,666,686,555,478,327,220,168,255,7482,7750,8371
E02000103,Dollis Hill,629,313,1146,989,1069,966,881,775,796,738,515,345,301,237,335,9093,9406,10035
E02000104,Wembley North,398,205,766,841,960,934,751,663,519,507,459,334,279,215,349,7577,7782,8180
E02000105,Sudbury East,571,275,1107,1116,1241,1280,1079,875,793,678,547,389,318,202,308,9933,10208,10779
E02000106,Neasden,617,344,1257,1175,1435,1312,1176,979,944,740,619,461,331,219,308,10956,11300,11917
E02000107,Cricklewood Anson Road,529,246,1212,1493,1582,1496,1335,1056,983,808,613,473,364,240,267,11922,12168,12697
E02000108,Sudbury West,407,194,829,790,815,805,740,580,538,476,367,305,236,168,253,6902,7096,7503
E02000109,Tokyngton,724,385,4421,3038,2492,2128,1538,1196,1035,821,653,477,301,279,412,18791,19176,19900
E02000110,Dudden Hill,354,190,863,1122,1140,1096,939,757,641,585,464,391,334,207,258,8797,8987,9341
E02000111,Wembley West,690,315,1529,1405,1730,1779,1438,1120,924,813,671,509,365,220,345,12848,13163,13853
E02000112,Wembley East,649,296,1541,1617,1832,1767,1434,1191,983,875,725,520,327,222,404,13438,13734,14383
E02000113,St Raphaels,720,339,1292,1005,923,906,769,762,797,803,605,379,272,181,246,8940,9279,9999
E02000114,Willesden Green,424,200,1046,1409,1574,1280,1134,842,786,610,482,344,272,166,247,10192,10392,10816
E02000115,Brondesbury,353,161,831,1273,1411,1260,1009,834,679,588,435,345,293,191,285,9434,9595,9948
E02000116,Roundwood Park,530,247,1067,1084,1152,1133,1030,906,807,658,498,294,213,160,198,9200,9447,9977
E02000117,Church End,879,412,1422,1211,1289,1293,1267,1187,1124,1061,750,475,327,249,384,12039,12451,13330
E02000118,Alperton East,667,302,1392,1293,1453,1359,1165,917,932,852,693,485,294,202,324,11361,11663,12330
E02000119,Stonebridge,647,320,1176,1072,1176,1037,854,796,786,691,504,322,243,172,270,9099,9419,10066
E02000120,Kilburn West,403,175,920,1366,1641,1440,1373,1111,884,734,507,334,301,187,240,11038,11213,11616
E02000121,Alperton West,747,406,1581,1459,1662,1739,1489,1089,866,787,627,466,331,221,305,12622,13028,13775
E02000122,Brondesbury Park,479,227,843,878,962,988,870,755,756,680,506,381,327,227,330,8503,8730,9209
E02000123,Harlesden,864,435,1698,1626,1682,1718,1622,1476,1495,1208,845,532,337,232,337,14808,15243,16107
E02000124,Queens Park,468,219,893,1173,1290,1298,1182,1012,905,721,524,414,298,230,270,10210,10429,10897
E02000125,Kensal Green,505,207,891,1077,1249,1238,1176,1017,926,804,629,436,304,223,367,10337,10544,11049
E02000126,Kilburn Park,467,252,913,845,943,849,779,740,735,609,426,286,216,164,196,7701,7953,8420
E02000127,Mottingham,571,257,790,606,771,860,825,724,677,629,489,365,351,222,359,7668,7925,8496
E02000128,Chislehurst North,373,174,528,413,546,649,656,533,580,543,455,334,399,275,362,6273,6447,6820
E02000130,Penge East,345,167,587,569,817,887,809,728,615,584,473,340,318,235,253,7215,7382,7727
E02000131,Crystal Palace Park,372,184,622,1011,1445,1394,1040,883,758,568,420,262,242,134,145,8924,9108,9480
E02000132,New Beckenham,317,140,469,722,1137,1088,1075,813,694,598,450,387,432,290,409,8564,8704,9021
E02000133,Chislehurst West & Elmstead,567,285,666,571,629,723,907,906,895,823,662,535,525,458,715,9015,9300,9867
E02000134,Bromley North & Sundridge,546,240,696,913,1279,1248,1142,1039,899,763,653,486,446,309,387,10260,10500,11046
E02000135,Anerley North & Penge West,505,264,871,894,1108,1062,878,808,835,728,545,378,254,183,277,8821,9085,9590
E02000136,Chislehurst East & Hoblingwell Wood,305,120,445,334,359,407,392,350,433,417,369,260,296,251,540,4853,4973,5278
E02000137,Shortlands Bromley Road,358,148,428,450,636,726,730,668,582,588,483,393,432,338,549,7003,7151,7509
E02000138,Beckenham East & Kelsey Park,291,131,425,504,672,783,770,679,615,640,556,437,463,462,679,7685,7816,8107
E02000139,Clock House & Cator Park,349,153,451,489,694,817,767,698,612,537,500,328,268,163,213,6537,6690,7039
E02000140,St Mary Cray North,574,256,784,598,656,674,638,612,651,595,417,291,306,204,276,6702,6958,7532
E02000141,Anerley South,309,145,476,465,654,772,709,638,578,510,372,271,241,165,220,6071,6216,6525
E02000142,Widmore,471,210,630,551,620,711,762,734,743,646,468,403,432,297,450,7447,7657,8128
E02000144,Bromley South,427,197,557,787,1094,1170,976,785,715,686,497,352,366,292,418,8695,8892,9319
E02000145,St Mary Cray East,515,241,733,592,698,723,661,628,635,599,454,341,307,244,285,6900,7141,7656
E02000146,Bickley West,460,203,606,603,866,892,928,793,734,664,523,373,339,267,509,8097,8300,8760
E02000147,Langley Park,463,253,633,470,403,501,650,622,639,707,566,447,482,367,492,6979,7232,7695
E02000148,Bickley East,336,156,445,342,387,423,510,554,516,498,455,350,396,326,425,5627,5783,6119
E02000149,St Mary Cray South,421,202,677,547,602,626,642,554,633,575,474,354,348,222,360,6614,6816,7237
E02000150,Eden Park & Bethlem,540,245,700,560,503,518,636,726,748,764,553,404,392,267,413,7184,7429,7969
E02000151,Petts Wood,392,169,434,357,467,556,668,595,590,566,456,416,438,383,503,6429,6598,6990
E02000152,Bromley Common,426,234,664,537,586,712,653,617,585,555,396,301,276,216,311,6409,6643,7069
E02000153,Hayes North,532,252,669,432,376,538,656,633,711,653,497,389,484,303,387,6728,6980,7512
E02000154,Orpington West,397,192,620,638,779,755,686,637,614,586,501,451,431,364,437,7499,7691,8088
E02000155,Orpington East,308,160,458,435,490,492,457,474,598,543,522,438,399,371,541,6218,6378,6686
E02000156,West Wickham,678,323,925,699,653,713,873,902,965,1001,878,711,735,584,921,10560,10883,11561
E02000157,Crofton,488,246,569,394,424,533,665,660,636,629,530,419,466,414,651,6990,7236,7724
E02000158,Goddington,493,230,637,426,501,584,612,504,590,591,444,351,418,363,503,6524,6754,7247
E02000159,Keston,388,208,598,427,421,394,440,503,621,635,492,397,473,331,490,6222,6430,6818
E02000160,Hayes South & Coney Hall,562,229,646,437,384,435,612,643,682,705,521,405,506,321,510,6807,7036,7598
E02000161,Orpington South,479,239,595,425,505,700,776,697,624,627,534,397,479,367,496,7222,7461,7940
E02000162,Farnborough,404,198,544,423,406,437,537,533,591,540,411,370,426,351,626,6195,6393,6797
E02000163,Chelsfield & Green Street Green,389,191,549,401,461,578,589,586,622,601,515,486,473,372,520,6753,6944,7333
E02000165,Biggin Hill West,369,199,577,412,500,488,493,495,528,535,445,402,403,278,263,5819,6018,6387
E02006782,Plaistow (Bromley),443,211,675,535,639,691,632,617,620,627,503,404,408,280,453,7084,7295,7738
E02006787,Elmers End,463,212,510,457,535,723,783,747,600,587,480,369,369,209,314,6683,6895,7358
E02006789,Biggin Hill East & Cudham,313,160,481,357,336,353,410,405,497,558,510,432,538,444,535,5856,6016,6329
E02000166,Highgate West,412,222,776,797,802,755,682,672,720,671,577,465,436,290,354,7997,8219,8631
E02000167,Hampstead Town,428,184,636,653,874,871,846,791,737,602,471,353,384,323,437,7978,8162,8590
E02000168,Tufnell Park West,382,179,799,1104,1132,924,826,680,650,625,475,378,290,245,252,8380,8559,8941
E02000169,Frognal,492,254,681,659,767,850,863,788,710,556,420,325,325,309,393,7646,7900,8392
E02000170,Fortune Green,430,190,871,1140,1231,1148,949,922,673,545,389,354,286,220,265,8993,9183,9613
E02000171,Mansfield Road & Park Hill Road,351,164,728,969,1104,1045,794,743,598,521,446,328,329,232,248,8085,8249,8600
E02000172,Kentish Town West,556,307,1630,1475,1509,1181,1036,815,772,682,488,396,308,205,307,10804,11111,11667
E02000173,Fitzjohns & Royal Free,399,152,835,1119,1355,1237,1053,856,709,491,362,268,269,228,287,9069,9221,9620
E02000174,Kentish Town East,391,190,1616,1463,1447,1109,852,656,620,573,430,342,248,194,220,9770,9960,10351
E02000175,West Hampstead,362,171,1194,1769,1824,1439,1066,773,601,476,367,306,270,183,194,10462,10633,10995
E02000176,Belsize Park,245,109,458,701,995,966,891,675,541,431,298,234,242,182,214,6828,6937,7182
E02000177,Chalk Farm,412,217,1256,1361,1367,1094,876,711,629,562,443,328,287,227,325,9466,9683,10095
E02000178,Kilburn Grange,346,159,920,1601,1727,1405,1092,855,698,570,417,315,295,187,188,10270,10429,10775
E02000179,Adelaide Road,321,171,632,697,802,801,687,571,513,425,316,264,222,170,238,6338,6509,6830
E02000180,Camden Road South,338,141,1310,1314,1355,975,716,608,555,495,357,292,232,167,185,8561,8702,9040
E02000181,South Hampstead,343,158,700,1195,1482,1302,1047,780,600,466,401,274,271,174,214,8906,9064,9407
E02000182,Swiss Cottage,434,202,925,1109,1263,1183,1051,722,632,463,377,270,223,207,301,8726,8928,9362
E02000183,Primrose Hill,344,179,768,923,1096,887,776,686,674,550,514,374,326,293,324,8191,8370,8714
E02000184,Camden Street & Elm Village,346,195,3079,1852,1575,1096,816,566,620,517,395,284,206,140,164,11310,11505,11851
E02000185,Kilburn East,503,279,1041,1218,1356,1144,933,876,708,634,449,370,327,248,272,9576,9855,10358
E02000186,Camden Town & Mornington Crescent,227,116,1270,1213,1098,871,596,499,472,409,330,234,168,140,158,7458,7574,7801
E02000187,Somers Town,516,271,2915,1898,1347,987,758,621,621,540,432,321,207,167,209,11023,11294,11810
E02000188,Euston,347,192,2391,1218,1010,727,574,573,530,509,330,260,179,121,175,8597,8789,9136
E02000189,Gray's Inn Road,222,119,2158,1547,1310,931,600,424,376,314,245,158,147,78,125,8413,8532,8754
E02000190,Bloomsbury East,182,82,4488,1572,1215,839,553,454,389,375,289,250,217,154,172,10967,11049,11231
E02000191,Fitzrovia East & Bloomsbury West,128,138,4828,1677,1268,748,630,564,374,369,274,184,138,124,115,11293,11431,11559
E02000192,Hatton Garden & Theobalds Road,259,157,1445,1260,1134,884,706,632,585,503,380,301,215,143,179,8367,8524,8783
E02000193,"Holborn, St Giles & Bloomsbury South",244,174,2997,1804,1318,1017,781,623,585,504,401,296,248,179,184,10937,11111,11355
E02000194,Crystal Palace Triangle,444,240,853,987,1268,1214,1008,916,730,693,511,338,302,196,315,9331,9571,10015
E02000195,Upper Norwood,541,303,870,795,872,917,866,809,753,771,671,507,409,308,500,9048,9351,9892
E02000196,Norbury East,420,231,841,847,978,869,721,635,621,644,517,392,316,248,375,8004,8235,8655
E02000197,Norbury West,571,259,918,893,1071,1011,1009,825,726,716,525,412,363,237,398,9104,9363,9934
E02000198,Thornton Heath North West,557,277,987,767,893,946,861,764,778,740,563,328,232,161,242,8262,8539,9096
E02000199,Thornton Heath North East,520,267,887,724,864,827,779,747,809,762,609,373,281,201,237,8100,8367,8887
E02000200,South Norwood Hill,411,191,682,739,963,955,841,721,738,661,511,324,261,187,302,7885,8076,8487
E02000201,South Norwood Central,522,235,740,718,942,918,779,704,692,654,476,331,227,140,212,7533,7768,8290
E02000202,Thornton Heath West,511,268,1019,834,979,921,799,700,752,734,608,429,307,212,352,8646,8914,9425
E02000203,Thornton Heath Central,462,238,766,732,836,820,829,683,720,652,528,337,257,187,281,7628,7866,8328
E02000204,West Thornton North,574,281,1151,1045,1110,1010,873,852,808,784,650,468,341,252,361,9705,9986,10560
E02000206,Selhurst North,610,283,944,935,1120,1110,979,843,903,707,539,415,252,177,265,9189,9472,10082
E02000207,Woodside & Ashburton,463,262,892,803,886,840,739,697,731,772,585,311,237,177,210,7880,8142,8605
E02000208,University Hospital & Queen's Road,712,322,1252,1103,1229,1267,1126,971,933,796,547,357,248,146,228,10203,10525,11237
E02000209,West Thornton South & Ampere Way,610,310,1051,950,964,922,831,772,789,714,514,345,233,173,192,8450,8760,9370
E02000210,Addiscombe North,464,229,771,655,849,855,780,708,710,678,489,334,247,169,227,7472,7701,8165
E02000211,Monks Orchard,411,205,626,557,570,517,532,505,632,676,570,473,497,395,490,7040,7245,7656
E02000212,Broad Green & Waddon Marsh,639,305,1120,943,1011,1054,966,843,841,689,502,309,202,145,187,8812,9117,9756
E02000213,Selhurst South & West Croydon,626,294,1238,1418,1695,1590,1251,976,920,782,576,343,273,198,275,11535,11829,12455
E02000214,Addiscombe East,313,170,504,437,490,496,454,440,509,546,454,355,326,218,330,5559,5729,6042
E02000215,Addiscombe West,497,235,876,1159,1686,1554,1175,958,878,727,581,438,349,245,371,10997,11232,11729
E02000216,Park Hill & Lloyd Park,397,169,490,515,779,844,848,616,439,429,391,322,308,248,465,6694,6863,7260
E02000217,Croydon Minster & Waddon North,650,298,1102,1143,1492,1444,1236,1002,819,776,551,313,255,154,206,10493,10791,11441
E02000218,Shirley East,444,237,666,494,444,418,460,484,493,520,389,331,276,202,252,5429,5666,6110
E02000219,Shirley West,333,190,603,503,462,424,441,464,571,654,610,515,543,459,636,6885,7075,7408
E02000220,Central Croydon,509,244,1109,1848,2360,2018,1499,1087,808,665,483,366,294,203,323,13063,13307,13816
E02000221,Waddon South,748,370,1099,859,932,946,931,817,809,747,542,364,337,231,404,9018,9388,10136
E02000222,Croham,362,171,553,639,871,851,784,703,599,572,402,334,282,190,287,7067,7238,7600
E02000223,New Addington North,819,383,1022,691,654,616,610,670,673,574,373,257,194,151,220,6705,7088,7907
E02000224,Purley North,395,197,648,655,845,880,748,651,539,565,395,313,275,208,217,6939,7136,7531
E02000225,New Addington Central,526,259,818,599,553,547,522,534,628,598,504,330,302,211,247,6393,6652,7178
E02000226,Selsdon,443,327,771,515,506,540,580,488,591,670,557,480,475,365,507,7045,7372,7815
E02000227,Forestdale,627,301,951,799,906,855,847,814,877,893,762,609,633,447,495,9888,10189,10816
E02000228,Sanderstead,431,177,566,435,408,605,615,550,572,584,553,482,498,396,593,6857,7034,7465
E02000229,New Addington South,500,251,646,473,510,539,449,465,541,521,344,253,216,149,244,5350,5601,6101
E02000230,Purley Central,531,279,829,682,936,899,895,781,735,814,588,546,482,369,565,9121,9400,9931
E02000231,Woodcote,414,221,691,581,575,550,591,527,599,654,584,514,432,335,495,7128,7349,7763
E02000232,Selsdon Park & Hamsey Green,341,184,537,355,421,393,477,426,519,490,403,330,431,272,430,5484,5668,6009
E02000233,Kenley North,342,158,477,408,516,583,522,429,489,419,341,282,249,189,349,5253,5411,5753
E02000234,Coulsdon,504,250,783,578,802,853,781,679,653,652,539,402,430,328,365,7845,8095,8599
E02000235,Kenley South,345,154,550,395,453,526,527,536,534,551,486,384,348,278,357,5925,6079,6424
E02000236,Woodmansterne,482,204,627,463,739,829,754,621,614,630,442,427,425,278,336,7185,7389,7871
E02000237,Old Coulsdon,375,177,532,419,501,599,578,476,533,579,527,449,489,401,500,6583,6760,7135
E02006788,South Norwood Park,442,250,735,596,707,710,626,603,616,592,435,274,255,145,179,6473,6723,7165
E02000238,Whitton Avenue West,621,300,1005,922,1135,1087,1031,927,770,668,580,395,306,221,244,9291,9591,10212
E02000239,Horsenden,520,245,880,847,1010,1020,966,717,704,638,618,441,366,275,390,8872,9117,9637
E02000240,Northolt West,752,362,1111,926,1042,1101,1037,948,870,747,572,436,343,241,289,9663,10025,10777
E02000241,Northolt East,421,220,647,620,751,712,689,602,560,497,417,314,247,168,229,6453,6673,7094
E02000242,Bilton Road,405,201,725,624,749,807,729,623,519,513,432,362,234,147,244,6708,6909,7314
E02000243,Greenford North,485,220,777,766,904,974,878,746,689,665,474,420,322,226,325,8166,8386,8871
E02000244,Perivale,409,192,687,662,752,947,847,735,629,541,440,309,311,220,264,7344,7536,7945
E02000245,Northolt South,601,260,801,831,904,908,835,724,646,591,478,319,230,149,225,7641,7901,8502
E02000246,Kingshill Avenue,685,301,985,733,860,842,841,691,702,674,490,354,308,192,263,7935,8236,8921
E02000247,Greenford West,750,342,1103,918,1056,1176,1128,905,889,653,549,396,340,236,458,9807,10149,10899
E02000248,Hanger Hill East,407,180,764,857,1006,1019,963,784,687,506,387,322,292,190,294,8071,8251,8658
E02000249,Greenford South,477,215,777,734,873,808,790,672,609,603,445,320,259,243,366,7499,7714,8191
E02000250,Pitshanger,387,190,469,459,464,537,663,623,575,454,402,422,353,238,344,6003,6193,6580
E02000251,Greenford Ravenor Park,503,230,807,810,859,867,849,694,636,601,537,444,310,209,328,7951,8181,8684
E02000252,North Acton,555,292,4056,2045,1797,1491,1178,961,768,626,474,366,244,177,267,14450,14742,15297
E02000253,Cuckoo Park,689,328,985,747,796,919,945,913,820,738,501,446,349,290,355,8804,9132,9821
E02000254,Southall North,588,283,1142,940,1069,1068,961,887,768,737,645,492,377,229,361,9676,9959,10547
E02000255,Drayton Green & Cleveland,628,278,914,842,899,957,923,819,761,749,568,433,425,299,364,8953,9231,9859
E02000256,Ealing Broadway West,390,185,810,1070,1261,1180,1033,806,730,635,477,351,331,229,345,9258,9443,9833
E02000257,Ealing Broadway East,759,321,1324,1867,2218,2096,1941,1470,1196,975,751,576,514,378,581,15887,16208,16967
E02000258,Acton Noel Road & Lynton Road,434,177,746,851,908,924,886,685,529,491,364,277,221,156,205,7243,7420,7854
E02000259,Brent Valley,424,205,526,521,548,633,645,621,534,471,375,282,224,162,214,5756,5961,6385
E02000260,Southall Park,655,269,1174,906,1188,1195,1137,1068,894,728,603,520,373,262,426,10474,10743,11398
E02000261,East Acton,750,331,1482,1938,2115,1824,1483,1101,965,830,538,439,354,253,323,13645,13976,14726
E02000262,Acton Central,477,213,1025,1223,1370,1290,1068,938,794,675,486,355,274,188,262,9948,10161,10638
E02000263,Southall West,908,448,1835,1479,1809,1820,1805,1549,1321,1114,867,620,450,284,489,15442,15890,16798
E02000264,Ealing Common & Twyford Ave,402,203,829,1241,1248,1129,950,851,680,610,492,397,306,232,375,9340,9543,9945
E02000265,West Ealing,606,276,986,1127,1411,1486,1425,1042,957,767,560,395,362,258,314,11090,11366,11972
E02000266,Norwood Green North & Windmill Park,847,409,1466,1272,1534,1373,1236,1118,1028,895,694,521,364,250,351,12102,12511,13358
E02000267,Hanwell,480,198,547,648,796,889,880,810,670,527,383,326,242,177,184,7079,7277,7757
E02000268,St Mary's,409,200,899,965,1018,1081,1006,852,721,701,539,444,418,260,328,9232,9432,9841
E02000269,Northfields,407,188,613,766,883,933,953,785,651,636,497,357,291,206,269,7840,8028,8435
E02000270,South Acton,447,204,844,1141,1416,1193,1041,782,660,573,395,295,199,152,217,8908,9112,9559
E02000271,Bedford Park,347,176,542,649,808,780,774,732,684,609,455,302,301,199,229,7064,7240,7587
E02000272,Elthorne Park,413,180,506,461,506,608,711,618,605,543,387,361,285,231,328,6150,6330,6743
E02000274,Southall Green,1131,512,2294,1711,2080,2139,2041,1864,1566,1164,939,670,469,270,379,17586,18098,19229
E02000275,Norwood Green South,444,241,897,826,1037,968,894,770,687,606,531,398,340,205,332,8491,8732,9176
E02000276,South Ealing,367,131,495,593,818,842,812,677,546,423,340,246,206,168,219,6385,6516,6883
E02006791,Chiswick North West,318,122,551,804,1000,1041,933,794,615,491,387,283,265,199,168,7531,7653,7971
E02000277,Bullsmoor & Freezywater,510,237,810,618,602,522,588,541,550,545,414,275,237,178,314,6194,6431,6941
E02000278,Turkey Street,740,366,1035,727,789,772,758,694,733,716,465,302,268,228,321,7808,8174,8914
E02000279,Enfield Lock,916,425,1211,978,1056,1034,1006,943,827,834,552,388,283,172,215,9499,9924,10840
E02000280,Chase & Crews Hill,478,214,620,517,593,690,717,694,621,606,514,387,397,296,386,7038,7252,7730
E02000281,Carterhatch & Forty Hall,605,298,893,641,705,721,838,690,727,661,445,322,306,224,322,7495,7793,8398
E02000282,Enfield Wash,731,324,1056,817,767,811,783,781,744,648,443,301,245,164,218,7778,8102,8833
E02000283,Brimsdown Avenue,631,319,1005,726,661,673,678,646,681,608,489,329,250,198,271,7215,7534,8165
E02000284,Chase Side,496,194,614,540,671,788,795,670,686,582,455,404,333,278,340,7156,7350,7846
E02000285,Enfield Town North,330,174,582,446,437,498,502,450,565,562,463,369,335,243,331,5783,5957,6287
E02000286,Chase Farm & The Ridgeway,385,133,507,519,668,701,767,635,572,568,537,476,438,352,592,7332,7465,7850
E02000287,Cockfosters & Hadley Wood,398,195,551,460,550,564,583,548,539,522,484,434,408,348,527,6518,6713,7111
E02000288,Southbury East,831,379,1236,901,983,979,1006,890,845,747,628,342,281,241,345,9424,9803,10634
E02000289,World's End,418,190,557,442,430,482,514,477,551,574,462,340,375,272,432,5908,6098,6516
E02000290,Brimsdown & Ponders End,518,206,651,529,608,629,589,498,464,405,312,244,145,112,172,5358,5564,6082
E02000291,Enfield Town South & Bush Hill Park,505,232,748,762,969,935,875,772,705,648,524,439,370,286,491,8524,8756,9261
E02000292,Southbury West,607,337,973,675,846,856,850,741,746,683,560,387,353,265,335,8270,8607,9214
E02000293,Grange Park,347,156,470,366,424,416,482,486,542,532,440,392,381,315,437,5683,5839,6186
E02000294,Ponders End South,682,332,1057,758,803,778,852,696,747,717,536,406,312,240,324,8226,8558,9240
E02000295,Oakwood Park & Highlands,493,253,607,547,667,777,799,728,628,611,526,386,340,253,522,7391,7644,8137
E02000296,Southgate,629,258,830,784,996,1060,1135,866,807,626,532,398,378,331,568,9311,9569,10198
E02000297,Bury Street West & Village Road,454,216,753,638,699,732,769,722,728,666,669,598,523,389,566,8452,8668,9122
E02000298,Winchmore Hill,466,201,607,526,580,640,670,690,702,664,563,456,393,324,426,7241,7442,7908
E02000299,Lower Edmonton North,774,375,1236,868,930,972,890,900,845,695,597,415,272,207,318,9145,9520,10294
E02000300,Haslebury North,616,328,935,744,822,815,730,679,626,620,524,357,242,189,260,7543,7871,8487
E02000301,Lower Edmonton South,775,394,1251,928,961,984,975,896,881,770,597,394,310,203,293,9443,9837,10612
E02000302,Palmers Green East,438,198,703,600,699,832,792,715,666,599,552,412,408,306,387,7671,7869,8307
E02000303,Haslebury South,586,307,1057,848,808,792,719,709,720,610,488,373,254,152,241,7771,8078,8664
E02000304,Southgate Green,415,195,552,538,607,598,665,578,624,624,531,447,436,344,502,7046,7241,7656
E02000305,Palmers Green West,430,213,710,717,976,1015,894,787,736,701,590,457,346,259,369,8557,8770,9200
E02000306,Edmonton Green,661,324,985,823,895,927,762,763,767,688,483,318,251,153,250,8065,8389,9050
E02000307,Tatem Park,659,331,1060,834,870,864,818,747,720,736,633,427,367,247,376,8699,9030,9689
E02000308,New Southgate & Arnos Grove,507,230,807,897,1072,910,983,740,655,651,459,358,290,240,311,8373,8603,9110
E02000309,Upper Edmonton East & Meridian Water,839,425,1331,1075,1169,1113,1096,1055,972,861,601,439,280,171,291,10454,10879,11718
E02000311,Bowes,600,274,982,905,1081,976,949,885,813,748,584,472,416,253,367,9431,9705,10305
E02000312,Broomfield Park,453,255,914,1080,1333,1351,1242,1008,856,808,661,489,383,256,458,10839,11094,11547
E02006793,Upper Edmonton West,683,337,1027,822,923,888,820,771,760,654,510,337,203,152,256,8123,8460,9143
E02000313,Thamesmead Birchmere Park,497,209,586,471,511,546,615,550,634,484,381,240,169,123,88,5398,5607,6104
E02000314,West Thamesmead,1015,437,2685,1728,1791,1767,1694,1534,1251,968,587,342,217,126,167,14857,15294,16309
E02000315,Abbey Wood North,744,310,991,776,888,834,772,761,815,677,496,360,229,161,242,8002,8312,9056
E02000316,"Woolwich Dockyard, Arsenal & Charlton Riverside",518,226,1273,2032,2436,2045,1451,1057,821,626,483,328,262,172,125,13111,13337,13855
E02000317,Woolwich West,489,240,1007,875,900,832,782,657,601,482,393,284,183,111,163,7270,7510,7999
E02000318,Plumstead High Street,548,246,1006,947,1234,1226,954,835,784,678,589,417,314,253,235,9472,9718,10266
E02000319,Plumstead Common & Riverside,550,256,933,1027,1219,1214,1096,872,804,678,486,341,244,166,164,9244,9500,10050
E02000320,Abbey Wood South,388,171,597,556,691,659,626,554,514,479,386,307,212,135,153,5869,6040,6428
E02000321,Woolwich Glyndon,450,216,667,665,808,785,641,636,588,492,383,263,205,124,173,6430,6646,7096
E02000323,Woolwich South,664,322,1143,1193,1564,1405,1173,1031,870,703,512,355,251,148,220,10568,10890,11554
E02000324,Charlton Village,472,211,664,664,753,770,689,582,558,495,382,319,216,167,228,6487,6698,7170
E02000326,Charlton Slopes,399,171,562,606,743,833,790,681,577,475,353,260,232,163,184,6459,6630,7029
E02000327,Woolwich Common,383,190,743,646,753,660,558,453,484,428,312,190,136,82,101,5546,5736,6119
E02000328,Westcombe Park & Maze Hill,309,138,425,594,758,599,672,586,495,452,376,289,260,192,259,5957,6095,6404
E02000329,Plumstead South,308,143,496,450,540,518,535,406,483,459,407,308,227,186,212,5227,5370,5678
E02000331,Hornfair Park,486,209,748,742,850,887,758,651,622,483,420,291,231,148,212,7043,7252,7738
E02000332,Shooters Hill,343,169,529,467,602,649,624,585,608,523,438,324,276,214,234,6073,6242,6585
E02000333,Blackheath Standard & Village,276,107,346,503,643,615,593,514,495,423,309,227,241,226,334,5469,5576,5852
E02000334,Kidbrooke North,365,176,606,471,550,674,609,501,530,497,372,309,260,176,223,5778,5954,6319
E02000335,Eltham North,310,112,468,382,470,588,616,511,516,478,391,325,314,226,308,5593,5705,6015
E02000337,Eltham West,546,220,794,648,718,771,765,676,630,626,493,381,315,230,257,7304,7524,8070
E02000339,Eltham Park,314,136,440,396,452,526,509,486,506,445,400,363,335,236,343,5437,5573,5887
E02000340,Eltham South,298,137,486,519,650,590,602,489,436,461,391,327,334,292,393,5970,6107,6405
E02000341,Middlepark & Horn Park,598,249,681,587,707,787,722,561,650,559,431,296,260,191,226,6658,6907,7505
E02000342,Avery Hill,297,133,846,539,547,514,490,382,388,362,286,225,232,128,214,5153,5286,5583
E02000343,Mottingham East,379,209,585,507,565,618,577,521,486,484,428,311,314,226,283,5905,6114,6493
E02000344,New Eltham,290,139,493,408,513,553,556,440,455,470,409,335,345,239,302,5518,5657,5947
E02006786,Wickham Lane & Winns Common,446,197,704,605,725,675,641,584,588,552,427,283,215,162,192,6353,6550,6996
E02006927,Kidbrooke South,594,265,857,1102,1333,1316,1167,864,787,741,564,432,438,345,454,10400,10665,11259
E02006928,Greenwich & Deptford Creekside,405,215,2371,2125,2328,1817,1241,767,603,523,339,240,173,100,103,12730,12945,13350
E02006929,Greenwich Peninsula,566,259,1460,2520,3149,2448,1477,966,770,590,482,297,226,173,185,14743,15002,15568
E02006930,Greenwich East,339,143,903,1390,1687,1413,1088,734,549,460,315,268,199,131,133,9270,9413,9752
E02006931,Greenwich Town & Park,394,168,900,1245,1298,1143,1023,789,748,624,467,327,298,242,278,9382,9550,9944
E02000345,Stamford Hill North,896,368,1349,890,849,816,680,567,469,388,348,275,242,129,155,7157,7525,8421
E02000346,Woodberry Down & Manor House,370,165,937,1470,1551,1198,804,598,550,463,406,260,194,113,151,8695,8860,9230
E02000347,Stamford Hill West,691,321,1059,892,869,759,639,520,416,417,313,296,188,122,187,6677,6998,7689
E02000348,Stamford Hill South,834,365,1108,961,934,831,674,561,507,512,364,240,185,105,152,7134,7499,8333
E02000350,Stoke Newington East & Cazenove,570,286,1022,1353,1448,1264,951,764,634,547,437,265,220,122,160,9187,9473,10043
E02000351,Brownswood,296,134,781,1555,1792,1326,996,645,541,542,374,265,172,129,144,9262,9396,9692
E02000352,Clissold North,354,168,597,742,909,742,654,544,455,453,308,262,228,112,184,6190,6358,6712
E02000353,Stoke Newington North,343,163,668,1067,1303,1063,852,656,617,574,378,271,221,111,187,7968,8131,8474
E02000354,Hackney Downs,500,236,972,1346,1610,1352,990,810,723,654,481,331,222,152,200,9843,10079,10579
E02000355,Lower Clapton,391,199,711,1106,1371,1212,919,756,672,552,420,296,229,136,243,8623,8822,9213
E02000356,Clissold South,312,151,537,879,1280,1024,815,653,584,547,346,251,155,120,138,7329,7480,7792
E02000357,Hackney Marshes,489,205,761,724,777,694,583,525,535,500,395,319,187,141,180,6321,6526,7015
E02000358,Stoke Newington South,510,240,1035,1835,2186,1776,1332,980,840,733,533,338,281,190,192,12251,12491,13001
E02000359,Homerton North,331,160,613,845,918,840,734,563,519,423,306,199,173,111,149,6393,6553,6884
E02000360,Amhurst Road & Pembury Estate,675,301,1126,1546,1791,1392,1219,902,847,823,648,414,284,161,211,11364,11665,12340
E02000361,Hackney Central,316,149,715,1520,1799,1217,893,683,531,542,323,244,147,96,150,8860,9009,9325
E02000362,Hackney Wick,350,186,748,1104,1182,991,644,522,473,439,343,210,149,102,127,7034,7220,7570
E02000363,Homerton South,831,365,1275,1423,1600,1338,1134,932,951,852,637,412,277,172,218,11221,11586,12417
E02000364,Dalston East,371,162,786,1357,1749,1321,973,714,683,608,464,359,264,194,244,9716,9878,10249
E02000365,Dalston Kingsland & De Beauvoir,461,208,1170,2737,3479,2509,1698,1055,804,781,573,381,331,227,283,16028,16236,16697
E02000366,South Hackney,449,214,851,1006,1178,1038,848,713,713,652,442,344,243,167,226,8421,8635,9084
E02000367,London Fields & Mare Street,454,219,985,1915,2466,1783,1337,1009,823,651,455,276,189,138,125,12152,12371,12825
E02000368,Haggerston East,495,249,1037,1519,1770,1292,991,774,695,666,517,349,256,159,196,10221,10470,10965
E02000369,Haggerston West & Kingsland Basin,608,306,1268,2160,2919,2163,1493,1052,899,755,567,378,246,179,229,14308,14614,15222
E02000370,Hoxton & Wenlock,389,178,1188,1670,1834,1324,913,712,604,563,419,241,181,103,120,9872,10050,10439
E02000371,Shoreditch,454,247,4131,4329,3594,2047,1243,946,746,601,422,269,187,117,160,18792,19039,19493
E02006918,Clapton Leaside,525,233,802,918,1106,1038,799,626,517,452,313,227,153,85,119,7155,7388,7913
E02006921,Upper Clapton,594,287,982,859,794,747,656,522,494,445,384,284,183,133,146,6629,6916,7510
E02000372,Old Oak & Wormwood,501,244,2070,2054,1775,1436,1142,943,823,680,553,360,285,158,235,12514,12758,13259
E02000373,White City,550,274,955,990,1021,896,667,601,586,517,391,267,177,139,168,7375,7649,8199
E02000374,Wormholt Road,404,166,1013,1110,1147,926,727,587,554,441,357,243,230,126,199,7660,7826,8230
E02000375,Shepherd's Bush North,318,166,983,1324,1403,1103,848,662,621,536,387,272,214,109,197,8659,8825,9143
E02000376,Shepherd's Bush West,266,118,809,1347,1507,1130,855,637,621,520,332,218,181,117,168,8442,8560,8826
E02000377,Askew,312,162,1181,1315,1317,1036,889,684,678,555,475,281,240,143,207,9001,9163,9475
E02000378,Shepherd's Bush South,254,118,752,1238,1290,1121,872,677,570,488,348,261,203,138,160,8118,8236,8490
E02000379,Ravenscourt Park North,394,186,631,752,837,834,831,744,674,551,357,288,269,210,288,7266,7452,7846
E02000380,Brackenbury,241,110,516,688,766,714,624,541,464,451,290,210,204,128,185,5781,5891,6132
E02000381,Brook Green,442,181,1237,1259,1231,1074,1009,850,756,618,412,301,275,184,226,9432,9613,10055
E02000382,Ravenscourt Park South,288,147,795,924,955,840,632,553,537,444,333,236,213,158,191,6811,6958,7246
E02000383,West Kensington,303,149,1381,1672,1611,1389,1085,850,709,649,492,393,373,254,360,11218,11367,11670
E02000384,Hammersmith Broadway,323,173,1063,1345,1508,1239,917,704,597,535,393,289,243,179,273,9285,9458,9781
E02000385,Barons Court,112,72,860,1425,1377,1030,741,519,391,337,218,176,144,99,115,7432,7504,7616
E02000386,North End,395,208,1269,1467,1527,1218,923,683,661,544,413,322,245,152,208,9632,9840,10235
E02000387,Lillie Road & Greyhound Road,232,121,973,1209,1151,925,665,548,464,359,286,227,155,137,147,7246,7367,7599
E02000388,Fulham Broadway,308,137,1113,1721,1685,1381,989,764,559,535,393,307,250,216,283,10196,10333,10641
E02000389,Fulham Reach,381,183,1169,1309,1363,1163,987,772,793,567,432,346,290,257,290,9738,9921,10302
E02000390,Fulham Aintree,242,111,825,1270,1253,979,761,586,447,385,250,219,156,144,150,7425,7536,7778
E02000391,Parsons Green East & Eel Brook Common,360,187,911,1225,1088,955,828,719,587,527,427,318,227,165,235,8212,8399,8759
E02000392,Parsons Green West,446,214,1238,1702,1694,1340,1091,833,776,632,397,276,233,169,208,10589,10803,11249
E02000393,Munster,261,109,656,1099,1041,967,745,621,457,311,212,180,174,127,158,6748,6857,7118
E02000394,Sands End & Chelsea Harbour,417,220,1179,1554,1567,1327,1098,788,711,562,390,332,231,194,198,10131,10351,10768
E02000395,Fulham Palace & Hurlingham Park,255,124,654,965,889,683,575,474,400,419,285,235,282,191,274,6326,6450,6705
E02000396,South Park,446,178,814,946,933,805,649,683,623,493,348,255,225,170,165,7109,7287,7733
E02000397,Bowes Park,392,166,694,850,1063,1065,928,706,672,537,405,276,223,160,200,7779,7945,8337
E02000398,Northumberland Park,519,272,861,737,792,798,651,704,707,648,471,275,179,119,180,7122,7394,7913
E02000400,Bounds Green,507,211,700,779,894,869,841,764,666,585,482,340,255,198,234,7607,7818,8325
E02000401,Roundway,420,279,874,671,670,621,626,566,604,594,460,283,185,137,170,6461,6740,7160
E02000402,Tottenham Bruce Castle Park,391,207,837,644,733,671,652,571,572,578,416,299,176,109,166,6424,6631,7022
E02000403,Wood Green North,343,148,677,982,1217,1136,938,727,580,485,384,251,202,131,198,7908,8056,8399
E02000404,Scotch Estate,390,193,778,932,1140,917,819,652,593,515,398,293,216,154,202,7609,7802,8192
E02000405,Alexandra Park,420,176,435,470,442,501,641,676,590,481,389,312,258,173,199,5567,5743,6163
E02000406,Noel Park,328,178,757,857,984,935,696,620,562,525,371,238,189,125,170,7029,7207,7535
E02000407,Bruce Grove North,441,212,837,808,999,828,836,768,738,617,412,256,156,138,217,7610,7822,8263
E02000408,Tottenham North West,494,221,857,834,860,860,736,717,715,627,471,279,222,135,207,7520,7741,8235
E02000409,Lordship Lane & Broadwater Farm,312,158,686,736,827,755,564,537,505,465,374,309,196,127,169,6250,6408,6720
E02000410,Muswell Hill North,414,193,565,528,592,628,683,651,590,512,377,318,269,171,188,6072,6265,6679
E02000411,Tottenham Lea Valley,558,242,1679,1426,1474,1261,1000,806,754,677,452,293,215,148,160,10345,10587,11145
E02000412,Wood Green South,334,156,908,1200,1331,1039,872,716,626,521,373,228,184,130,194,8322,8478,8812
E02000413,Fortis Green & Coldfall,558,264,651,608,630,676,788,722,687,634,427,338,269,219,318,6967,7231,7789
E02000414,Bruce Grove South,346,174,690,823,1069,1025,850,750,654,563,428,268,184,125,204,7633,7807,8153
E02000415,Downhills Park,312,159,733,1018,1189,1091,822,672,597,445,339,274,220,124,230,7754,7913,8225
E02000416,Hornsey East,395,183,754,941,1287,1098,932,736,634,561,391,305,242,167,188,8236,8419,8814
E02000417,Muswell Hill South,305,173,465,594,649,636,649,631,547,504,369,322,305,218,269,6158,6331,6636
E02000418,Hornsey West,283,136,378,400,497,530,542,486,458,460,363,332,300,200,222,5168,5304,5587
E02000419,Harringay Ladder North,335,163,826,1386,1695,1411,1102,759,700,494,356,292,217,143,227,9608,9771,10106
E02000420,Tottenham Green West,332,163,746,1065,1285,1156,944,745,698,606,478,350,241,162,179,8655,8818,9150
E02000421,Tottenham Green East,404,217,1069,1070,1225,980,800,687,684,590,413,257,174,123,232,8304,8521,8925
E02000422,West Green & St Ann's,434,200,889,997,1131,1024,924,744,668,577,403,291,197,146,198,8189,8389,8823
E02000423,Harringay East,238,109,697,1363,1541,1154,944,644,565,433,316,240,154,105,172,8328,8437,8675
E02000424,Hornsey Vale,293,146,546,728,876,829,690,628,579,551,381,308,218,141,130,6605,6751,7044
E02000425,South Tottenham,890,348,1076,699,815,823,800,556,422,412,301,217,161,105,153,6540,6888,7778
E02000426,Highgate Wood,360,165,607,623,678,640,606,641,589,459,402,317,297,242,369,6470,6635,6995
E02000427,Harringay Ladder South,232,98,712,1180,1427,1124,889,700,548,481,317,213,160,101,161,8013,8111,8343
E02000428,Harringay Warehouse District & Vartry,447,200,1018,1291,1360,1050,744,625,671,570,374,233,158,132,166,8392,8592,9039
E02000429,Crouch End West,345,137,364,563,782,829,742,676,638,545,395,326,299,209,260,6628,6765,7110
E02000430,Crouch End East,265,113,513,857,1068,908,760,662,614,533,382,274,245,151,149,7116,7229,7494
E02000431,Highgate East,222,114,454,804,848,798,655,543,500,412,251,246,214,153,206,6084,6198,6420
E02000432,Stroud Green,169,94,488,982,1098,883,698,563,489,469,321,238,202,128,106,6665,6759,6928
E02006794,White Hart Lane,588,275,981,811,893,906,817,833,747,697,432,299,182,142,196,7936,8211,8799
E02000433,Stanmore Park,437,230,628,646,710,715,717,664,581,578,577,485,490,474,888,8153,8383,8820
E02000434,Canons Park,514,251,846,870,1107,1017,999,776,713,626,615,532,485,327,595,9508,9759,10273
E02000435,Stanmore Uxbridge Road,402,191,681,599,609,622,588,535,508,447,493,394,428,300,474,6678,6869,7271
E02000436,Hatch End North,267,118,399,350,336,390,419,361,407,456,443,379,420,298,414,5072,5190,5457
E02000437,Harrow Weald,520,218,800,673,721,711,702,640,603,683,528,456,421,335,502,7775,7993,8513
E02000438,Hatch End South,456,213,692,624,610,650,690,604,590,567,530,406,370,282,499,7114,7327,7783
E02000439,Edgware West,566,254,1001,1021,1150,1101,994,758,725,626,556,445,294,215,334,9220,9474,10040
E02000440,Belmont,570,280,875,817,755,867,850,821,687,694,586,574,421,302,423,8672,8952,9522
E02000441,Pinner Green,383,186,555,443,534,672,678,534,533,503,432,398,375,304,391,6352,6538,6921
E02000442,Queensbury East,531,240,1071,1174,1258,1116,939,765,697,620,580,420,284,215,270,9409,9649,10180
E02000443,Wealdstone North,684,334,1145,1109,1113,1165,1007,826,814,666,571,407,324,255,404,9806,10140,10824
E02000444,Queensbury West,513,224,884,892,932,931,835,648,610,556,546,463,350,232,337,8216,8440,8953
E02000445,Wealdstone South,640,313,1143,1103,1228,1282,1082,922,794,730,567,450,363,276,470,10410,10723,11363
E02000447,Headstone Lane,459,223,623,610,684,754,790,600,519,528,482,384,367,279,279,6899,7122,7581
E02000448,Pinner Central,411,183,428,361,420,588,609,519,506,464,413,376,398,321,491,5894,6077,6488
E02000449,Kenton East,445,203,885,951,1000,939,800,636,594,630,539,430,324,227,333,8288,8491,8936
E02000451,North Harrow,362,151,551,484,538,617,617,516,507,475,401,400,356,260,338,6060,6211,6573
E02000452,Greenhill North,488,212,1315,1198,1448,1292,1061,776,655,521,404,319,248,170,235,9642,9854,10342
E02000453,Pinner Road,446,226,735,814,911,1053,857,705,646,572,404,388,291,182,302,7860,8086,8532
E02000454,Pinner South,458,188,509,399,386,585,709,575,517,483,427,404,342,293,384,6013,6201,6659
E02000455,Greenhill South,446,190,957,1388,1965,1725,1185,848,701,540,486,385,320,257,385,11142,11332,11778
E02000456,West Harrow,366,180,701,707,752,711,782,613,554,505,403,358,264,194,304,6848,7028,7394
E02000457,Rayners Lane North,392,154,663,615,700,746,643,534,547,495,439,384,294,269,363,6692,6846,7238
E02000459,South Harrow,606,253,908,789,1011,1022,908,745,660,609,454,388,304,208,286,8292,8545,9151
E02000460,Newton Farm,473,236,767,656,764,863,747,590,544,482,371,312,220,128,177,6621,6857,7330
E02000461,Harrow-on-the-Hill,773,467,859,606,694,686,707,555,462,430,345,277,219,180,275,6295,6762,7535
E02000462,Alexandra Park,407,199,723,644,824,765,693,626,570,553,454,332,240,188,277,6889,7088,7495
E02000463,Earlsmead,601,288,924,757,766,776,769,730,661,631,550,407,328,208,253,7760,8048,8649
E02006795,Rayners Lane South,483,236,831,773,840,921,854,686,581,576,490,418,300,226,320,7816,8052,8535
E02006882,Kenton West,742,313,1435,1457,1680,1613,1335,1035,1039,1030,1019,879,719,496,690,14427,14740,15482
E02000464,Dagnam Park & Noak Hill,465,214,725,508,636,626,616,526,512,467,434,357,308,236,357,6308,6522,6987
E02000465,Petersfield Avenue & Duck Wood,538,239,770,657,795,899,762,691,653,631,534,326,324,180,221,7443,7682,8220
E02000466,Havering-atte-Bower & Chase Cross,487,247,805,671,696,745,606,598,654,574,541,411,416,298,418,7433,7680,8167
E02000467,Harold Hill East,819,361,1011,858,963,979,948,752,791,655,557,389,367,180,262,8712,9073,9892
E02000468,Collier Row & Park Farm,467,230,746,531,616,631,648,566,627,585,462,403,401,287,442,6945,7175,7642
E02000469,Harold Hill West,439,221,528,522,545,580,533,504,508,450,408,304,306,226,289,5703,5924,6363
E02000470,Harold Park & Harold Wood,379,190,635,693,934,906,663,652,656,612,571,462,481,390,522,8177,8367,8746
E02000471,Rise Park,341,163,582,500,446,489,497,461,525,605,553,484,499,383,525,6549,6712,7053
E02000472,Romford North,494,237,721,557,714,674,664,631,636,610,539,476,473,347,439,7481,7718,8212
E02000473,Ardleigh Green,484,213,803,649,774,837,779,687,690,707,617,483,473,356,502,8357,8570,9054
E02000474,Romford North West,456,226,717,605,741,751,688,592,590,599,487,380,360,254,456,7220,7446,7902
E02000475,Gidea Park,410,188,613,597,710,725,664,623,672,641,573,491,501,425,634,7869,8057,8467
E02000476,Central Romford,397,178,694,940,1138,1037,781,663,557,526,432,340,315,250,383,8056,8234,8631
E02000477,Romford East,414,222,719,580,761,729,692,648,701,679,637,532,530,387,525,8120,8342,8756
E02000478,Emerson Park,275,131,467,374,330,391,339,331,441,468,465,389,460,367,464,5286,5417,5692
E02000479,Romford South,469,205,712,784,985,896,788,684,663,593,495,336,324,216,305,7781,7986,8455
E02000480,Rush Green,721,345,1098,1190,1405,1271,1065,875,811,792,627,459,378,273,434,10678,11023,11744
E02000481,Cranham East,415,193,647,531,564,608,555,525,585,615,530,393,451,384,611,6999,7192,7607
E02000482,Upminster North & Cranham West,371,175,519,320,310,404,487,495,550,465,381,398,402,290,564,5585,5760,6131
E02000483,Hornchurch,310,152,582,597,669,614,475,491,556,585,535,438,433,330,566,6871,7023,7333
E02000484,Hylands,408,214,692,611,584,545,563,569,630,709,625,445,445,301,402,7121,7335,7743
E02000485,Upminster Bridge,397,179,629,542,637,662,651,567,606,587,522,420,383,328,464,6998,7177,7574
E02000486,Elm Park East,266,138,575,502,533,516,497,439,537,623,519,437,394,329,465,6366,6504,6770
E02000487,Upminster South & Corbets Tey,402,195,633,459,435,447,510,599,597,657,595,502,595,415,598,7042,7237,7639
E02000488,Hacton,296,164,529,483,507,555,477,410,500,634,511,482,516,371,448,6423,6587,6883
E02000489,Elm Park West,435,195,660,603,724,723,666,573,577,582,578,394,384,316,417,7197,7392,7827
E02000490,South Hornchurch,400,186,738,559,650,626,544,505,586,593,512,337,420,299,460,6829,7015,7415
E02000491,Hornchurch Marshes,587,311,928,779,795,816,725,698,700,672,536,380,370,293,372,8064,8375,8962
E02000492,Rainham East & Wennington,313,168,509,472,503,413,415,417,485,529,439,374,374,311,464,5705,5873,6186
E02000493,Rainham West,365,186,582,521,589,628,506,440,447,443,376,277,221,155,250,5435,5621,5986
E02000494,Ducks Hill,406,206,464,427,513,582,730,640,654,632,585,543,522,395,649,7336,7542,7948
E02000495,Northwood,556,234,775,731,924,993,1075,856,824,680,528,491,495,424,633,9429,9663,10219
E02000496,Harefield,401,203,615,497,614,614,551,537,623,606,513,428,397,295,381,6671,6874,7275
E02000497,Northwood Hills,499,211,679,579,671,758,797,670,696,705,577,438,376,350,567,7863,8074,8573
E02000498,West Ruislip North,292,134,435,358,432,490,491,432,463,453,432,380,400,269,363,5398,5532,5824
E02000499,Eastcote,356,182,592,496,502,669,616,559,602,632,552,449,412,336,584,7001,7183,7539
E02000500,Ruislip,391,200,584,610,632,618,662,575,637,645,604,456,462,358,581,7424,7624,8015
E02000501,Ruislip Manor,398,214,569,517,588,787,779,583,662,653,502,407,371,314,431,7163,7377,7775
E02000502,West Ruislip South,452,192,525,552,775,890,838,622,573,518,415,375,318,237,453,7091,7283,7735
E02000503,Ruislip Gardens,427,199,650,530,673,794,731,595,665,657,527,398,323,222,331,7096,7295,7722
E02000504,Ickenham,411,186,537,402,459,535,623,540,572,569,503,382,383,333,491,6329,6515,6926
E02000506,Uxbridge Common & Swakeleys,412,193,662,542,526,561,597,586,621,610,538,501,448,345,516,7053,7246,7658
E02000507,Hillingdon North East,524,233,734,572,658,777,715,579,624,549,457,374,282,190,312,6823,7056,7580
E02000508,Uxbridge Central & Brunel,429,207,2629,1530,1351,1367,1092,795,637,511,413,341,256,191,299,11412,11619,12048
E02000509,Uxbridge West,379,201,2434,1920,1371,1086,814,675,577,455,408,335,242,166,213,10696,10897,11276
E02000510,Hillingdon South,518,248,952,730,720,826,771,683,680,600,554,414,376,283,393,7982,8230,8748
E02000511,Charville,599,311,1128,855,820,885,835,773,737,729,530,374,317,287,437,8707,9018,9617
E02000512,Hillingdon Heath,531,274,912,710,754,816,756,697,649,591,431,315,253,209,259,7352,7626,8157
E02000513,Yeading North,676,288,999,807,983,974,911,786,704,624,449,269,233,147,225,8111,8399,9075
E02000514,Yeading West,690,308,1249,976,1189,1234,1146,985,815,745,585,451,329,220,343,10267,10575,11265
E02000515,Yiewsley West,630,270,1269,1206,1533,1417,1191,908,848,777,578,413,346,230,298,11014,11284,11914
E02000516,Yeading Brookside,567,258,997,743,892,923,896,811,728,612,458,363,260,162,202,8047,8305,8872
E02000517,Hayes End,794,342,1073,892,1045,1094,966,906,781,640,501,405,294,221,309,9127,9469,10263
E02000518,Yiewsley East,590,281,937,732,844,821,796,703,726,598,481,361,322,211,276,7808,8089,8679
E02000519,Hayes Town North,625,298,1068,842,929,898,850,783,703,659,563,386,314,203,352,8550,8848,9473
E02000520,Hayes Town & Lake Farm,880,391,1686,1509,1763,1712,1567,1225,1125,917,722,494,373,252,376,13721,14112,14992
E02000521,West Drayton East,889,393,1547,1455,1634,1639,1397,1051,882,804,583,403,278,200,289,12162,12555,13444
E02000522,West Drayton West,547,260,852,767,1065,1072,930,729,663,663,457,399,313,227,368,8505,8765,9312
E02000523,Hayes South,662,304,1563,1390,1651,1554,1308,1101,914,786,578,472,290,224,276,12107,12411,13073
E02000524,"Heathrow, Hardmonsworth & Sipson",364,158,833,875,1034,1014,934,717,667,568,446,297,229,152,191,7957,8115,8479
E02000525,Harlington & Cranford Cross,682,295,1014,1019,1209,1249,1146,939,896,729,532,355,273,164,241,9766,10061,10743
E02006796,South Ruislip,463,251,849,779,1007,1071,971,739,701,617,477,373,325,261,394,8564,8815,9278
E02000526,Chiswick North East,485,242,782,820,905,968,895,918,796,713,497,419,354,267,317,8651,8893,9378
E02000528,Brentford East,736,299,1103,1177,1512,1750,1517,1161,1024,820,647,529,419,298,312,12269,12568,13304
E02000529,Heston North,590,275,1132,999,1218,1187,1004,841,713,582,512,448,302,216,272,9426,9701,10291
E02000530,North Hyde & North Cranford,574,264,982,707,806,808,769,652,641,525,400,305,206,124,174,7099,7363,7937
E02000531,Brentford Central,546,234,1005,1011,1356,1393,1212,929,840,774,584,453,365,268,344,10534,10768,11314
E02000532,Chiswick South East,537,228,826,727,754,831,897,855,826,789,607,493,441,320,323,8689,8917,9454
E02000533,Chiswick South West,498,204,683,710,868,859,877,861,755,634,519,414,385,264,280,8109,8313,8811
E02000534,Brentford West & Osterley Park,453,205,703,768,876,919,916,724,626,505,418,348,312,255,330,7700,7905,8358
E02000535,Heston West,561,241,1116,989,1286,1291,1081,833,793,614,632,538,378,300,359,10210,10451,11012
E02000536,Heston Central & Lampton West,605,293,1083,1064,1351,1368,1189,964,808,644,630,485,376,258,379,10599,10892,11497
E02000537,Osterley & Lampton East,543,251,965,1059,1344,1634,1270,905,716,617,542,437,369,273,399,10530,10781,11324
E02000538,Cranford,600,294,1158,1203,1413,1390,1142,999,923,666,569,498,325,212,265,10763,11057,11657
E02000539,Syon Green,691,309,950,890,1201,1404,1378,1082,902,722,546,403,331,247,306,10362,10671,11362
E02000540,Spring Grove,678,250,1153,1244,1807,1828,1508,1119,845,767,594,417,369,238,348,12237,12487,13165
E02000541,Hounslow Meadows,625,282,1069,1063,1534,1656,1353,1004,870,710,603,415,355,248,377,11257,11539,12164
E02000542,Hounslow West,772,362,1293,1272,1884,2089,1664,1224,1013,764,601,488,362,248,380,13282,13644,14416
E02000543,Hounslow High Street,837,362,1395,1592,2450,2605,2111,1380,1035,843,609,460,329,228,289,15326,15688,16525
E02000544,Hounslow East,443,235,715,718,868,907,939,697,630,648,588,429,378,236,309,8062,8297,8740
E02000545,Isleworth & Ivybridge,551,254,766,704,897,958,913,818,643,627,460,383,353,193,269,7984,8238,8789
E02000546,Hounslow Heath,622,326,993,937,1227,1338,1137,976,840,617,524,421,348,209,304,9871,10197,10819
E02000547,North Feltham & Hatton,640,264,913,987,1154,1126,1027,886,828,743,589,440,366,272,369,9700,9964,10604
E02000548,Bedfont,642,276,994,851,1028,1077,958,729,726,688,547,377,342,189,280,8786,9062,9704
E02000549,Feltham East,736,386,1221,1187,1294,1312,1248,1047,975,938,707,520,444,313,456,11662,12048,12784
E02000550,Feltham Central,757,313,1057,952,1218,1462,1320,950,786,737,539,345,273,164,225,10028,10341,11098
E02000551,Hanworth North,648,274,948,746,901,883,920,724,715,593,471,366,292,208,204,7971,8245,8893
E02000552,Lower Feltham,523,282,979,665,825,1004,1000,749,685,560,437,320,235,170,212,7841,8123,8646
E02000553,Hanworth South,435,176,603,500,572,620,648,614,506,510,393,317,297,183,237,6000,6176,6611
E02006792,Chiswick Park,383,159,723,1149,1261,1332,1078,914,735,618,450,346,313,280,394,9593,9752,10135
E02000554,Highcroft & Holly Park,465,201,973,1230,1308,1156,895,770,699,682,494,330,289,170,203,9199,9400,9865
E02000555,Archway East,448,180,1075,1388,1355,1099,857,765,759,650,484,376,301,239,274,9622,9802,10250
E02000556,Tollington,382,156,1443,2031,1952,1480,1047,822,773,706,534,340,306,184,212,11830,11986,12368
E02000557,Archway West,333,145,955,1217,1346,1075,839,687,674,584,467,333,230,225,265,8897,9042,9375
E02000558,Finsbury Park West,477,214,1155,1460,1465,1118,811,748,651,612,447,290,261,159,261,9438,9652,10129
E02000559,Gillespie Road,373,172,646,1303,1559,1264,952,755,625,581,385,304,220,150,194,8938,9110,9483
E02000560,Holloway Nag's Head,217,107,1036,1697,1560,1109,768,590,505,434,266,215,166,140,169,8655,8762,8979
E02000561,Tufnell Park East,307,160,903,1214,1231,945,662,613,563,515,371,309,281,190,184,7981,8141,8448
E02000562,Highbury,350,181,695,1097,1464,1059,797,621,601,544,386,290,263,172,209,8198,8379,8729
E02000563,Hilldrop,380,176,1138,1313,1425,1125,861,651,605,604,434,333,248,167,207,9111,9287,9667
E02000564,Lower Holloway,351,175,2489,2714,2741,1923,1183,844,693,636,464,313,240,167,190,14597,14772,15123
E02000565,Newington Green,379,199,883,1390,1488,1132,776,591,584,542,379,234,192,141,178,8510,8709,9088
E02000566,Highbury Fields,340,173,731,1402,1804,1218,935,607,609,559,395,343,278,197,200,9278,9451,9791
E02000567,Canonbury East & Mildmay Park,395,164,813,1660,2212,1590,1110,803,725,676,496,370,295,183,242,11175,11339,11734
E02000568,Caledonian Road,457,232,2768,2518,2030,1513,1136,796,682,658,425,357,279,177,268,13607,13839,14296
E02000569,Islington North & Canonbury West,462,198,902,1596,1938,1479,1058,770,708,686,549,377,305,206,303,10877,11075,11537
E02000570,Barnsbury East,292,123,751,1446,1876,1321,886,651,593,582,442,347,329,163,230,9617,9740,10032
E02000571,Islington East & Arlington,305,182,736,1338,1653,1232,852,606,623,582,403,306,249,179,216,8975,9157,9462
E02000572,Barnsbury West,453,201,2135,1793,1530,1035,731,613,640,498,413,326,232,158,232,10336,10537,10990
E02000573,Angel,313,135,1315,2163,2492,1768,1126,760,673,634,513,373,312,215,249,12593,12728,13041
E02000574,King's Cross & Pentonville,231,187,2187,1938,1919,1293,805,643,631,558,419,271,236,140,200,11240,11427,11658
E02000575,Clerkenwell,349,185,3866,3075,2470,1680,1164,772,780,738,507,325,276,175,233,16061,16246,16595
E02000576,Old Street & St Luke's,418,192,2350,2217,2075,1350,956,810,625,597,455,286,235,150,257,12363,12555,12973
E02000577,Golborne & Swinbrook,400,202,1037,958,995,861,757,728,711,653,496,348,283,187,279,8293,8495,8895
E02000578,Ladbroke Grove,321,152,603,573,599,535,482,478,474,494,400,234,230,154,222,5478,5630,5951
E02000579,North Kensington,405,201,797,856,938,875,812,762,749,745,579,440,332,284,284,8453,8654,9059
E02000580,Portobello,303,157,670,1026,1224,1082,950,807,807,806,589,428,349,238,234,9210,9367,9670
E02000581,Notting Dale,354,199,729,636,669,677,651,564,599,628,453,335,312,247,304,6804,7003,7357
E02000582,Notting Hill Gate,243,113,880,973,1241,1090,904,837,685,552,461,329,273,213,325,8763,8876,9119
E02000583,Notting Hill West,264,124,546,691,868,859,756,664,699,631,467,325,283,208,276,7273,7397,7661
E02000584,Notting Hill South,389,193,661,722,933,936,875,833,757,604,465,333,350,252,314,8035,8228,8617
E02000585,Holland Park,436,201,927,936,924,1054,993,1006,842,783,565,400,328,317,322,9397,9598,10034
E02000586,Queen's Gate,439,212,1299,1031,1021,871,844,868,742,703,438,315,276,206,222,8836,9048,9487
E02000587,Kensington Abingdon,362,177,902,863,912,875,868,791,737,619,474,403,334,248,297,8323,8500,8862
E02000588,Hans Town,301,154,826,889,890,803,747,839,842,728,493,404,314,242,299,8316,8470,8771
E02000589,Kensington Gardens,300,167,1859,1665,1502,1220,1008,963,789,645,446,293,256,173,226,11045,11212,11512
E02000590,Brompton,239,119,925,889,807,704,609,572,636,554,466,351,302,246,337,7398,7517,7756
E02000591,Earl's Court,291,131,1228,1363,1199,1093,821,797,670,556,421,295,307,218,201,9169,9300,9591
E02000592,South Kensington,306,129,1099,1052,1062,809,761,787,657,557,382,253,214,183,248,8064,8193,8499
E02000593,West Brompton,273,126,1391,1136,1238,1094,985,869,776,649,375,333,291,218,205,9560,9686,9959
E02000594,Chelsea Manor & Royal Hospital,268,121,595,662,697,581,622,586,689,623,507,428,370,334,495,7189,7310,7578
E02000595,Chelsea Riverside East,230,172,860,841,784,660,689,593,638,630,448,332,347,285,329,7436,7608,7838
E02000596,Fulham Road,256,108,988,1017,1082,852,721,691,581,511,407,286,261,181,251,7829,7937,8193
E02000597,Chelsea Riverside West,351,154,762,830,794,751,690,627,605,609,497,377,335,223,277,7377,7531,7882
E02000598,Tudor Drive,662,286,645,399,384,500,810,870,782,679,534,395,378,269,333,6978,7264,7926
E02000599,Kingston Vale & Coombe Hill,490,249,1152,783,483,481,548,621,684,603,527,426,404,330,533,7575,7824,8314
E02000600,Kingston Hill,544,239,842,893,1009,919,951,921,663,536,426,321,329,244,292,8346,8585,9129
E02000601,Kingston North,861,370,1155,1046,1219,1396,1490,1344,1143,823,577,440,378,266,303,11580,11950,12811
E02000602,Kingston East & Norbiton West,524,216,1730,1319,1235,1121,972,893,737,557,387,362,305,179,248,10045,10261,10785
E02000603,Norbiton East,558,262,1126,819,797,810,829,780,736,596,418,351,296,189,246,7993,8255,8813
E02000604,New Malden East,520,286,724,705,886,1018,1032,955,821,724,528,442,365,254,327,8781,9067,9587
E02000605,New Malden West,487,235,677,578,661,752,847,832,730,702,504,411,370,279,423,7766,8001,8488
E02000606,Kingston Riverside,353,158,1685,1716,1635,1282,1170,963,769,600,477,388,355,239,311,11590,11748,12101
E02000607,Berrylands North,340,162,1072,742,593,597,598,517,514,419,330,263,243,177,215,6280,6442,6782
E02000608,Surbiton North,207,97,790,989,1036,877,739,643,501,361,284,219,212,144,190,6985,7082,7289
E02000609,Malden Manor,475,240,738,587,611,544,643,694,631,631,532,382,417,289,377,7076,7316,7791
E02000610,Surbiton South,264,121,521,846,1026,942,907,615,562,448,352,306,307,205,348,7385,7506,7770
E02000611,Berrylands South,434,222,576,385,373,553,664,622,620,535,486,421,432,332,414,6413,6635,7069
E02000612,Motspur Park,419,211,609,537,607,659,759,666,635,602,551,459,502,381,480,7447,7658,8077
E02000613,Southborough,395,193,501,527,626,842,765,732,611,483,387,289,304,226,340,6633,6826,7221
E02000614,Tolworth,528,246,911,789,849,920,879,767,751,669,507,410,315,235,296,8298,8544,9072
E02000615,Hook,443,216,689,577,614,668,643,604,663,618,469,340,354,273,351,6863,7079,7522
E02000616,Chessington North,304,145,427,400,509,550,546,446,453,430,355,265,268,204,215,5068,5213,5517
E02000617,Chessington South & Malden Rushett,461,220,792,659,688,730,712,637,659,678,494,425,367,296,348,7485,7705,8166
E02000619,Lambeth Walk & North Kennington,450,210,1083,1331,1374,1069,894,792,816,739,541,398,302,190,251,9780,9990,10440
E02000620,Kennington West & Vauxhall North,427,192,1591,1906,1597,1264,1024,817,881,727,537,374,226,190,281,11415,11607,12034
E02000621,Vauxhall South,325,195,3555,3329,2585,1845,1324,1007,872,772,606,389,278,183,250,16995,17190,17515
E02000622,Oval,317,165,1219,1762,1519,1096,873,674,650,654,475,315,184,128,165,9714,9879,10196
E02000623,Stockwell North,390,179,963,1287,1185,1057,867,784,727,732,508,333,217,181,206,9047,9226,9616
E02000624,Stockwell East,375,199,1001,1885,1723,1281,891,771,770,676,506,289,213,120,193,10319,10518,10893
E02000625,Stockwell West,514,224,1229,1781,1536,1237,993,844,836,708,499,288,186,97,134,10368,10592,11106
E02000626,Loughborough Road,505,253,989,1038,1144,921,826,728,853,809,542,296,167,122,165,8600,8853,9358
E02000627,Stockwell South,394,200,1517,2188,1753,1246,1021,783,777,665,440,280,210,143,223,11246,11446,11840
E02000628,Brixton North,516,267,1384,1905,1811,1309,1073,895,959,887,627,377,277,176,247,11927,12194,12710
E02000629,Clapham North,307,132,1196,2299,1905,1175,897,706,633,526,403,258,187,125,139,10449,10581,10888
E02000630,Clapham Old Town,254,100,843,1641,1464,1068,760,590,518,449,356,264,204,122,160,8439,8539,8793
E02000631,Herne Hill East,428,212,876,1385,1433,1042,923,811,798,656,468,312,252,166,222,9344,9556,9984
E02000632,Acre Lane,200,106,1262,3025,2224,1326,910,641,592,500,343,217,165,101,177,11483,11589,11789
E02000633,Brixton Central,384,189,894,1633,1441,1105,766,687,648,658,425,282,189,137,174,9039,9228,9612
E02000634,Clapham Common North,260,116,899,1545,1281,844,640,494,499,472,365,242,176,110,182,7749,7865,8125
E02000635,Poets' Corner & Brockwell Park,377,183,963,1574,1643,1154,899,715,754,716,526,324,220,126,173,9787,9970,10347
E02000636,Clapham South,313,118,856,1710,1298,923,777,622,513,435,303,187,216,128,152,8120,8238,8551
E02000637,Brixton Hill East,287,127,739,1821,1628,1151,828,637,637,599,373,257,183,122,184,9159,9286,9573
E02000638,Brixton Hill West,379,216,1135,1966,1883,1385,1078,863,812,709,491,284,191,161,232,11190,11406,11785
E02000639,Clapham Park East & Streatham Hill North,365,205,1008,1382,1447,1103,933,798,718,693,424,314,179,106,157,9262,9467,9832
E02000640,Clapham Park West,361,162,917,1720,1525,1079,944,724,568,486,385,274,207,186,220,9235,9397,9758
E02000641,Tulse Hill,499,268,953,1102,1156,894,868,771,777,691,482,343,210,123,215,8585,8853,9352
E02000642,West Dulwich,523,260,777,1027,1187,1046,996,802,778,658,459,364,315,201,252,8862,9122,9645
E02000643,Streatham Hill,402,187,839,1358,1641,1200,1022,797,659,589,432,277,202,126,206,9348,9535,9937
E02000644,Leigham Vale & Royal Circus,424,199,702,985,1297,1132,958,779,681,583,434,278,244,117,194,8384,8583,9007
E02000645,West Norwood East,455,208,782,1081,1286,1098,1009,884,786,652,467,299,248,152,203,8947,9155,9610
E02000646,Streatham Central,412,165,832,1379,1645,1350,1089,837,682,610,411,345,271,203,263,9917,10082,10494
E02000647,West Norwood West & Streatham East,414,197,714,817,953,953,813,732,723,658,478,397,292,183,330,8043,8240,8654
E02000648,West Norwood South,514,235,789,641,826,840,755,718,702,595,379,255,209,149,196,7054,7289,7803
E02000649,Streatham Green,558,198,1057,1723,2053,1651,1379,1085,882,751,493,362,257,168,256,12117,12315,12873
E02000650,Gipsy Hill,434,182,659,724,1041,952,869,737,661,604,445,274,216,116,161,7459,7641,8075
E02000651,Streatham Common,426,173,727,984,1166,1113,973,748,654,622,494,364,252,194,279,8570,8743,9169
E02000652,Streatham Vale,429,207,800,800,891,902,837,683,535,559,488,319,236,187,292,7529,7736,8165
E02006801,"Lambeth North, Waterloo & South Bank",259,307,4426,2538,1742,1146,841,613,598,565,486,359,273,185,223,13995,14302,14561
E02000653,Silwood & Pepys,473,263,1412,2224,2543,1827,1123,799,751,695,456,285,168,122,142,12547,12810,13283
E02000654,Deptford North,555,253,1069,1307,1319,1093,826,705,730,684,425,268,175,108,163,8872,9125,9680
E02000655,New Cross Gate,441,220,1379,1471,1446,1157,939,778,669,623,406,268,161,118,173,9588,9808,10249
E02000657,New Cross South,406,190,1832,1539,1490,1232,1029,772,655,614,457,287,215,159,205,10486,10676,11082
E02000658,Telegraph Hill,350,166,912,1257,1239,940,794,714,659,665,461,315,211,138,208,8513,8679,9029
E02000659,Blackheath West,373,183,940,977,1093,996,826,691,595,563,374,269,223,178,200,7925,8108,8481
E02000660,Brockley East & St Johns,311,137,783,1258,1397,1179,849,686,645,471,353,215,166,128,142,8272,8409,8720
E02000661,Blackheath Village,282,121,503,660,765,796,756,631,541,493,339,246,237,180,284,6431,6552,6834
E02000662,Brockley West,441,200,751,906,1061,909,870,722,689,599,438,272,167,129,156,7669,7869,8310
E02000663,Loampit & Hilly Fields,311,147,629,805,879,880,664,604,570,522,378,258,191,148,176,6704,6851,7162
E02000664,Lewisham Central & Park,596,280,1668,2216,2608,2103,1533,1137,924,778,576,349,259,178,307,14636,14916,15512
E02000665,Manor House,395,190,632,756,979,986,928,747,612,559,405,267,246,152,254,7523,7713,8108
E02000666,Ladywell,350,155,574,752,808,703,679,618,549,520,358,243,174,153,242,6373,6528,6878
E02000667,Crofton Park,299,121,407,513,668,741,754,537,462,442,311,238,198,141,193,5605,5726,6025
E02000668,Lee,392,159,508,482,667,736,711,611,527,487,359,273,219,179,194,5953,6112,6504
E02000669,Hither Green,304,148,518,791,1126,1014,874,631,530,489,386,208,181,127,181,7056,7204,7508
E02000670,Catford East & Mountsfield Park,307,164,554,637,766,695,604,500,508,485,349,222,151,123,199,5793,5957,6264
E02000671,Honor Oak,366,180,575,806,1091,1095,952,786,647,553,435,283,245,153,223,7844,8024,8390
E02000672,Catford Bridge,481,227,779,1023,1179,1166,949,782,764,732,492,275,207,155,263,8766,8993,9474
E02000673,Forest Hill West,400,148,527,736,986,865,798,685,603,528,429,307,224,168,181,7037,7185,7585
E02000674,Corbett Estate,372,211,761,633,778,799,752,603,648,713,517,322,245,204,302,7277,7488,7860
E02000675,Grove Park & Lee South,412,191,631,672,769,867,748,617,583,595,505,407,359,225,313,7291,7482,7894
E02000676,Forest Hill East,372,157,571,662,988,959,782,654,620,557,384,284,193,138,225,7017,7174,7546
E02000677,Culverley Green,312,169,676,606,661,647,614,557,553,598,510,325,265,166,283,6461,6630,6942
E02000678,Further Green,442,207,703,523,535,610,550,491,535,514,355,238,147,121,179,5501,5708,6150
E02000679,Perry Vale,434,180,628,721,887,905,796,631,611,577,383,299,246,168,203,7055,7235,7669
E02000680,Upper Sydenham,417,165,564,542,788,714,629,633,536,459,355,229,167,114,173,5903,6068,6485
E02000681,Bellingham & Perry Hill,505,268,813,679,729,791,796,670,706,743,535,382,308,181,263,7596,7864,8369
E02000682,Forster Park & Southend,653,310,944,697,731,784,712,704,738,713,515,321,267,185,267,7578,7888,8541
E02000683,Chinbrook,346,195,619,540,648,673,574,471,528,505,373,299,198,165,237,5830,6025,6371
E02000685,Sydenham Wells,425,214,629,588,812,797,805,651,625,566,412,306,261,183,283,6918,7132,7557
E02000686,Beckenham Hill,524,219,720,587,699,712,623,611,607,577,412,231,178,125,139,6221,6440,6964
E02000687,Lower Sydenham,369,185,589,711,824,860,785,656,590,614,438,318,252,204,299,7140,7325,7694
E02006783,Downham East,551,262,775,600,707,735,647,637,682,586,440,251,168,125,197,6550,6812,7363
E02006784,Downham West,501,210,707,572,628,724,668,632,647,576,457,369,291,192,324,6787,6997,7498
E02006798,New Cross & Deptford South,430,195,1223,1497,1628,1267,963,833,754,673,464,298,180,133,170,10083,10278,10708
E02000689,Wimbledon Park & Durnsford Road,492,198,738,961,1166,1161,1032,798,730,534,423,339,246,181,193,8502,8700,9192
E02000690,Wimbledon Common,421,187,561,348,325,388,497,605,566,532,463,417,386,314,466,5868,6055,6476
E02000691,Wimbledon Broadway North,394,156,628,892,1002,1010,891,732,585,480,389,273,238,157,232,7509,7665,8059
E02000692,Wimbledon Hill,484,185,573,877,1015,979,1005,896,734,652,496,383,404,279,504,8797,8982,9466
E02000693,Colliers Wood,297,117,730,1468,1908,1588,1272,868,667,493,400,307,256,149,252,10358,10475,10772
E02000694,South Wimbledon,417,144,596,1051,1294,1361,1157,928,645,462,363,289,280,156,217,8799,8943,9360
E02000695,Graveney,412,195,817,1038,1122,1101,991,789,659,619,532,371,268,256,323,8886,9081,9493
E02000696,Lavender Park,411,174,840,1068,1253,1119,977,776,710,565,417,287,222,119,147,8500,8674,9085
E02000697,Wimbledon Broadway South,353,149,605,1219,1368,1363,1160,915,638,493,330,260,237,127,191,8906,9055,9408
E02000698,Cottenham Park,664,269,676,561,608,746,985,934,780,615,481,434,418,314,402,7954,8223,8887
E02000699,Wimbledon Chase,442,202,525,705,974,1092,1083,811,605,466,373,304,286,186,294,7704,7906,8348
E02000700,Merton Church Road & Phipps Bridge,492,210,739,872,1137,1037,918,734,699,586,454,319,235,159,165,8054,8264,8756
E02000701,Mitcham East,521,279,879,858,1007,1031,980,844,731,639,562,416,283,221,300,8751,9030,9551
E02000702,Lonesome,590,264,809,727,957,1039,854,757,719,592,461,345,263,156,245,7924,8188,8778
E02000703,Merton Park,475,220,651,638,678,666,825,774,672,571,465,405,423,298,416,7482,7702,8177
E02000704,Raynes Park,399,147,618,884,1141,1211,1089,811,601,524,395,313,279,223,329,8418,8565,8964
E02000705,Rowan Road,530,219,943,819,959,980,939,738,787,692,541,458,311,247,394,8808,9027,9557
E02000706,Mitcham West,658,328,956,838,1022,1080,1050,829,752,688,527,357,238,157,229,8723,9051,9709
E02000707,Pollards Hill,538,300,950,785,781,739,674,695,662,719,527,329,243,159,254,7517,7817,8355
E02000708,West Barnes,523,236,784,661,794,1008,1040,910,793,656,531,422,383,224,362,8568,8804,9327
E02000709,Cannon Hill,447,185,589,496,584,746,806,678,597,582,492,404,383,293,432,7082,7267,7714
E02000710,Mitcham South,509,235,752,725,857,914,802,744,674,622,516,407,358,264,420,8055,8290,8799
E02000711,Morden Central,555,262,846,918,1134,1132,1015,843,750,674,478,308,263,170,285,8816,9078,9633
E02000712,St Helier North,579,294,875,725,816,853,875,782,775,735,521,373,326,212,375,8243,8537,9116
E02000713,Lower Morden,456,206,641,537,572,669,651,565,602,630,477,366,384,234,370,6698,6904,7360
E02000714,Forest Gate North,481,209,879,866,1114,1136,895,673,580,593,401,277,154,118,149,7835,8044,8525
E02000715,Little Ilford West,597,272,918,724,819,852,769,632,497,466,327,221,150,116,164,6655,6927,7524
E02000716,Manor Park North,503,233,895,809,1028,1072,823,654,476,436,333,280,161,98,157,7222,7455,7958
E02000717,Manor Park South,609,259,1068,859,1110,1109,978,801,615,504,389,266,182,116,147,8144,8403,9012
E02000718,Little Ilford East,577,272,957,720,790,828,731,615,519,405,324,194,140,101,136,6460,6732,7309
E02000719,Forest Gate West,401,194,918,1119,1334,1196,942,786,644,501,432,269,171,111,145,8568,8762,9163
E02000720,Forest Gate East,437,222,961,940,1164,1153,911,641,522,516,431,304,202,127,179,8051,8273,8710
E02000721,Forest Gate South,678,281,1354,1361,1567,1528,1170,889,717,596,489,325,207,115,186,10504,10785,11463
E02000722,Stratford East,407,181,938,1292,1473,1288,947,769,631,489,389,254,178,98,186,8932,9113,9520
E02000723,East Ham North,636,302,1514,1650,1864,1791,1289,962,805,696,563,436,243,170,269,12252,12554,13190
E02000724,Plashet East,656,307,1435,1320,1425,1424,1060,816,636,499,473,305,191,144,194,9922,10229,10885
E02000725,Stratford Central,384,164,1263,1826,1930,1490,1011,696,650,487,400,267,184,115,160,10479,10643,11027
E02000726,Olympic Park & Mill Meads,855,383,5332,7024,5030,3395,1940,1331,1007,760,566,336,188,116,147,27172,27555,28410
E02000727,Plashet West,583,273,1282,1275,1471,1426,1130,805,612,504,390,319,170,103,162,9649,9922,10505
E02000728,Wallend North,574,255,1223,1207,1288,1225,1028,772,651,499,379,311,198,120,137,9038,9293,9867
E02000729,West Ham Park,369,170,774,919,1065,974,768,620,555,399,310,285,184,110,172,7135,7305,7674
E02000730,Upton Park,544,235,1301,1372,1711,1575,1231,856,652,475,462,344,262,157,235,10633,10868,11412
E02000731,East Ham Central,626,316,1402,1303,1575,1464,1224,943,763,569,451,312,245,141,190,10582,10898,11524
E02000732,East Ham West,561,268,1112,1071,1134,1057,822,708,619,468,394,248,162,111,150,8056,8324,8885
E02000733,West Ham & Stratford Park,562,257,1356,1455,1556,1277,1107,782,777,684,477,349,264,142,162,10388,10645,11207
E02000734,Plaistow North,441,231,905,971,1018,874,754,606,575,538,401,237,170,105,157,7311,7542,7983
E02000735,Plaistow North East,547,249,1007,1068,1232,1143,902,740,649,467,364,261,193,161,204,8391,8640,9187
E02000736,Wallend South,719,356,1127,898,1014,1007,918,784,704,565,376,245,180,115,146,8079,8435,9154
E02000737,East Ham South,723,338,1251,957,1025,1119,1018,910,803,618,443,330,222,137,199,9032,9370,10093
E02000738,East Ham South West,698,318,1119,1075,1100,1224,1021,815,691,546,376,270,181,111,161,8690,9008,9706
E02000739,Plaistow Park,418,229,919,982,1098,973,798,715,636,483,363,267,196,101,120,7651,7880,8298
E02000740,Canning Town North,396,176,828,885,1004,840,702,614,552,495,365,238,160,93,105,6881,7057,7453
E02000741,Plaistow South,608,271,906,922,1030,1042,893,769,714,584,406,284,194,104,136,7984,8255,8863
E02000742,Lonsdale Avenue,697,311,1027,766,858,918,848,742,650,528,363,245,156,108,160,7369,7680,8377
E02000743,Canning Town Central,628,306,1311,1477,1606,1272,966,857,798,662,491,324,183,117,195,10259,10565,11193
E02000744,Canning Town East,548,283,1011,1038,1301,1115,928,796,731,568,378,256,199,136,153,8610,8893,9441
E02000745,Beckton North,512,256,949,974,1156,1032,910,739,729,620,454,333,200,96,126,8318,8574,9086
E02000746,Beckton,482,206,1332,1331,1476,1214,909,663,598,489,397,284,180,79,110,9062,9268,9750
E02000747,Canning Town South & Bow Creek,559,279,1484,2508,2537,1921,1205,814,741,650,514,322,221,172,141,13230,13509,14068
E02000748,Beckton Park,446,167,869,799,855,873,834,650,482,401,320,243,137,95,94,6652,6819,7265
E02000749,Custom House,589,276,1232,1147,1218,1142,882,712,766,653,420,316,224,125,185,9022,9298,9887
E02000750,Royal Docks & North Woolwich,736,356,1907,3159,3400,2649,1780,1267,1007,788,552,317,199,127,112,17264,17620,18356
E02000751,Woodford Wells,546,300,844,709,743,814,903,800,869,833,670,631,648,520,688,9672,9972,10518
E02000752,Hainault East,520,205,721,678,870,884,811,660,627,527,427,295,264,193,252,7209,7414,7934
E02000753,Hainault West,392,191,622,578,703,721,604,513,542,461,339,269,226,168,252,5998,6189,6581
E02000754,Woodford Green,351,169,535,508,585,661,655,519,474,485,422,292,289,169,232,5826,5995,6346
E02000755,Woodford Bridge,294,143,432,380,487,505,481,428,407,397,315,227,214,187,193,4653,4796,5090
E02000756,Fairlop,800,346,1269,1202,1405,1455,1312,1041,1051,965,741,576,540,402,461,12420,12766,13566
E02000757,South Woodford High Road,580,271,816,1001,1288,1318,1297,1007,869,780,662,501,478,320,470,10807,11078,11658
E02000758,Clayhall North,414,184,677,483,509,537,578,516,442,463,415,288,270,183,301,5662,5846,6260
E02000759,Roding,727,347,1012,955,1227,1427,1272,1060,981,907,649,519,402,282,381,11074,11421,12148
E02000760,Barkingside North,472,228,708,661,660,703,703,587,559,477,389,329,286,215,315,6592,6820,7292
E02000762,Barkingside West,336,184,621,579,604,567,544,468,489,410,452,309,289,202,319,5853,6037,6373
E02000763,Aldborough Hatch,435,220,723,600,790,771,673,597,522,491,354,282,271,184,235,6493,6713,7148
E02000764,Snaresbrook,498,201,723,975,1182,1267,1227,924,910,786,681,561,531,454,745,10966,11167,11665
E02000765,Barkingside East,381,195,672,708,786,825,712,519,462,408,400,298,220,152,294,6456,6651,7032
E02000767,Newbury Park,525,230,790,724,878,969,856,682,551,463,397,329,277,206,320,7442,7672,8197
E02000768,Wanstead,350,144,394,426,483,536,525,486,449,460,347,264,314,175,278,5137,5281,5631
E02000769,Chadwell Heath West,1153,516,1607,1306,1464,1596,1499,1259,1061,1005,769,546,370,258,584,13324,13840,14993
E02000770,Seven Kings Park,487,251,938,720,770,799,726,659,582,491,396,331,274,176,254,7116,7367,7854
E02000772,Goodmayes North,564,298,926,750,944,950,930,694,554,450,365,312,190,129,182,7376,7674,8238
E02000773,Ley Street,676,337,1109,879,988,997,903,806,709,596,484,319,241,185,247,8463,8800,9476
E02000774,Seven Kings Meads Lane,483,227,929,761,935,930,716,575,533,432,357,311,228,140,202,7049,7276,7759
E02000776,Ilford North East,457,215,659,596,787,853,763,623,447,379,362,292,205,145,184,6295,6510,6967
E02000777,Wanstead Flats,273,125,416,429,532,593,522,508,420,447,400,332,314,198,224,5335,5460,5733
E02000779,Ilford North West,539,255,890,981,1383,1458,1062,815,606,460,397,316,201,131,224,8924,9179,9718
E02000780,Ilford South East,1247,539,2079,1847,2502,2620,2088,1490,1153,900,735,555,409,239,358,16975,17514,18761
E02000781,South Park,1031,495,1760,1347,1564,1590,1374,1142,1036,905,764,597,467,343,503,13392,13887,14918
E02000782,Ilford South West,763,344,1368,1241,1716,1634,1215,927,724,547,470,333,216,137,254,10782,11126,11889
E02000783,Loxford Park,572,265,1013,809,886,912,755,642,546,440,323,205,177,106,160,6974,7239,7811
E02006800,Goodmayes South,898,458,1613,1355,1705,1664,1522,1159,1007,840,666,598,367,221,295,13012,13470,14368
E02006924,Valentines Park & Cranbrook,806,416,1397,1317,1583,1533,1236,1074,969,740,740,622,497,335,552,12595,13011,13817
E02006925,Clayhall South,864,450,1534,1155,1215,1075,1161,1018,980,913,814,664,549,397,570,12045,12495,13359
E02000784,North Barnes,661,354,998,803,727,785,955,1009,1041,1007,753,533,529,456,544,10140,10494,11155
E02000785,Kew Gardens,497,229,713,679,818,916,971,1019,955,803,646,460,504,366,568,9418,9647,10144
E02000786,Mortlake & South Barnes,602,264,804,817,1176,1320,1381,1281,1089,924,660,506,537,353,421,11269,11533,12135
E02000787,North Sheen,707,320,830,961,1231,1382,1445,1247,1101,878,612,439,488,332,428,11374,11694,12401
E02000788,East Sheen North,532,209,635,539,725,898,1070,979,817,716,524,421,439,289,368,8420,8629,9161
E02000789,Queen's Road,339,160,441,506,567,681,720,643,615,526,430,282,309,226,301,6247,6407,6746
E02000790,St Margarets,429,191,472,405,541,648,742,764,677,525,355,254,224,163,162,5932,6123,6552
E02000791,Richmond Central,305,125,848,649,769,823,852,744,621,554,417,293,319,237,268,7394,7519,7824
E02000792,Twickenham Marble Hill,448,202,492,463,581,620,799,836,718,571,436,342,352,289,368,6867,7069,7517
E02000793,Whitton,442,198,686,539,598,695,774,688,638,544,496,382,369,289,387,7085,7283,7725
E02000794,Twickenham North,401,184,494,484,557,668,806,750,605,493,373,317,268,201,263,6279,6463,6864
E02000795,"Richmond Park, Sheen Gate & Petersham",667,257,587,366,333,429,630,694,658,591,438,326,369,341,399,6161,6418,7085
E02000796,Heathfield,661,287,936,741,815,906,1015,870,848,736,599,519,490,357,479,9311,9598,10259
E02000797,Twickenham Town,415,181,500,603,817,837,911,887,725,553,389,323,297,186,210,7238,7419,7834
E02000798,Twickenham West,790,362,813,623,715,904,1133,1216,1098,852,601,461,440,315,359,9530,9892,10682
E02000799,Strawberry Hill,398,189,864,501,411,475,588,575,561,571,410,328,307,227,249,6067,6256,6654
E02000800,Ham,424,183,431,294,318,375,543,518,510,437,341,278,234,192,206,4677,4860,5284
E02000801,Teddington North,350,169,443,417,536,600,691,711,657,596,427,325,330,235,222,6190,6359,6709
E02000802,Hampton Hill,415,147,465,421,532,527,634,692,551,593,449,339,368,267,366,6204,6351,6766
E02000803,Nursery Lands & Hampton North,523,223,674,553,650,760,869,770,731,785,608,545,527,346,493,8311,8534,9057
E02000804,Teddington Central,350,192,499,460,520,556,693,665,685,602,461,343,379,275,339,6477,6669,7019
E02000805,Hampton Wick & Teddington East,653,299,898,776,760,854,1054,1083,1043,930,736,562,513,356,474,10039,10338,10991
E02000806,Hampton Village,550,237,670,583,640,741,888,919,874,867,661,607,565,420,500,8935,9172,9722
E02000807,Rotherhithe,236,103,783,1622,1843,1546,1023,695,512,469,396,310,214,121,124,9658,9761,9997
E02000808,Borough & Southwark Street,238,164,3966,2787,1931,1350,877,681,684,644,456,280,222,129,183,14190,14354,14592
E02000809,Bermondsey North,268,146,1415,2762,2675,1905,1323,955,849,725,449,330,197,111,100,13796,13942,14210
E02000810,Bermondsey East,554,240,1118,1816,2053,1546,1155,871,786,668,472,320,264,159,187,11415,11655,12209
E02000812,London Bridge & Bermondsey West,467,209,1901,2096,1745,1349,931,888,830,730,521,305,225,145,278,11944,12153,12620
E02000813,Canada Water,477,203,1196,1943,1950,1384,933,733,682,614,436,287,211,126,167,10662,10865,11342
E02000814,Surrey Quays,294,123,1025,2067,2285,1907,1217,838,622,569,447,352,223,136,165,11853,11976,12270
E02000815,Elephant & Castle,266,160,2529,1776,1228,882,715,550,471,403,281,145,88,75,83,9226,9386,9652
E02000816,South Bermondsey Central,421,206,1183,1416,1544,1151,899,723,663,633,471,292,213,130,192,9510,9716,10137
E02000817,South Bermondsey East,326,175,707,951,931,720,589,504,502,412,368,280,184,124,235,6507,6682,7008
E02000818,Walworth North,347,195,1562,1939,1679,1295,922,799,711,605,458,309,222,177,213,10891,11086,11433
E02000819,South Bermondsey West,442,194,1113,1144,1107,944,804,709,751,664,459,276,179,126,178,8454,8648,9090
E02000820,Kennington East,410,204,1860,1874,1570,1264,978,848,777,718,479,316,191,162,186,11223,11427,11837
E02000821,Burgess Park,529,269,1053,1064,1122,985,948,845,802,723,465,252,194,122,155,8730,8999,9528
E02000822,Walworth South,370,198,855,1040,1037,832,745,623,683,561,412,227,157,90,130,7392,7590,7960
E02000823,Burgess Park West & John Ruskin Street,432,187,1018,1369,1266,1072,844,727,765,688,486,298,218,169,216,9136,9323,9755
E02000824,Peckham Park Road,600,289,1169,1235,1264,971,910,905,927,822,623,351,242,150,213,9782,10071,10671
E02000825,Peckham North West,590,287,1129,1249,1286,1096,1014,905,929,879,619,346,214,145,193,10004,10291,10881
E02000826,Camberwell North,449,243,1121,1319,1500,1143,964,855,837,731,521,331,215,154,185,9876,10119,10568
E02000827,Camberwell Green,633,275,1100,1603,1607,1300,1127,1058,1025,909,647,381,282,145,233,11417,11692,12325
E02000828,Peckham North,499,236,1176,1238,1372,1016,863,874,863,802,542,294,212,133,183,9568,9804,10303
E02000829,Queens Road Peckham,482,222,947,1436,1741,1306,1074,835,851,773,610,411,268,203,341,10796,11018,11500
E02000830,Camberwell South,322,142,1247,1448,1495,1086,887,694,736,625,500,272,236,171,229,9626,9768,10090
E02000831,Peckham Rye,412,195,865,1466,1636,1207,1026,810,745,661,490,311,238,142,243,9840,10035,10447
E02000832,Nunhead North,466,233,886,1105,1315,1055,841,771,766,735,548,394,303,178,260,9157,9390,9856
E02000833,North Dulwich,417,192,786,894,995,805,697,656,575,564,359,221,154,127,168,7001,7193,7610
E02000834,Peckham Rye Common,355,149,533,1218,1525,1108,994,764,610,524,429,298,265,172,223,8663,8812,9167
E02000835,Nunhead South & Newlands,448,159,527,691,804,831,743,643,574,539,407,265,177,114,188,6503,6662,7110
E02000836,East Dulwich,402,185,595,861,1081,997,845,707,642,585,430,334,217,167,228,7689,7874,8276
E02000837,Herne Hill & Dulwich Park,604,270,727,750,702,696,800,866,710,695,541,413,349,245,376,7870,8140,8744
E02000838,Dulwich Hill,494,216,690,990,1291,1126,1074,916,715,624,532,352,297,196,237,9040,9256,9750
E02000839,Sydenham Hill,526,276,693,654,794,808,817,802,665,576,482,352,310,280,311,7544,7820,8346
E02006802,Southwark St George's,317,155,2464,2013,1641,1239,907,710,723,603,456,259,192,124,174,11505,11660,11977
E02000840,Middleton Circle,624,267,771,675,842,820,742,717,661,616,433,291,211,153,209,7141,7408,8032
E02000841,St Helier South,607,272,842,716,748,810,830,721,722,662,510,356,206,172,233,7528,7800,8407
E02000842,Stonecot,434,211,716,544,578,664,712,630,646,641,471,439,391,269,372,7073,7284,7718
E02000843,Hackbridge,457,169,509,672,1032,1120,870,655,604,568,402,300,253,153,249,7387,7556,8013
E02000844,The Wrythe,551,270,796,573,704,740,755,697,698,599,453,314,304,189,282,7104,7374,7925
E02000845,Worcester Park East,566,253,660,518,718,925,976,898,719,647,473,344,315,224,310,7727,7980,8546
E02000846,Sutton North,469,176,618,443,513,604,700,600,602,545,395,361,318,250,376,6325,6501,6970
E02000847,North Cheam West,437,214,644,575,582,796,851,683,619,665,531,501,496,420,514,7877,8091,8528
E02000848,North Cheam East,532,245,673,503,466,608,700,708,578,610,490,317,308,278,350,6589,6834,7366
E02000849,Wallington North,440,211,540,527,618,736,746,611,630,608,404,344,328,259,313,6664,6875,7315
E02000850,Beddington,649,297,892,685,734,801,895,839,847,875,629,517,467,322,406,8909,9206,9855
E02000851,Sutton Central,561,211,782,1006,1245,1329,1186,910,733,658,447,366,310,257,363,9592,9803,10364
E02000852,Sutton East,443,195,548,547,661,756,825,688,621,593,405,324,293,222,371,6854,7049,7492
E02000853,Sutton West,473,179,554,506,637,772,835,658,610,548,404,311,286,203,271,6595,6774,7247
E02000854,Carshalton Village,382,176,472,440,560,621,726,638,654,540,448,395,307,249,304,6354,6530,6912
E02000855,Cheam High Street,458,213,621,509,474,500,674,652,621,651,548,438,425,327,490,6930,7143,7601
E02000856,Wallington South,509,210,644,592,686,845,807,795,699,614,525,411,406,296,371,7691,7901,8410
E02000857,Sutton South West,415,171,471,629,883,992,989,806,586,495,398,347,314,256,500,7666,7837,8252
E02000858,Roundshaw,547,272,800,656,729,693,703,626,621,590,408,308,272,212,216,6834,7106,7653
E02000859,Carshalton on the Hill,482,221,602,466,576,629,721,651,601,568,502,433,456,346,610,7161,7382,7864
E02000860,Sutton South & Shanklin,378,152,463,661,875,952,870,705,609,528,404,318,340,198,333,7256,7408,7786
E02000861,Carshalton Beeches & Banstead Road,455,198,528,448,395,462,650,631,625,616,574,482,454,404,439,6708,6906,7361
E02000863,"Orchard Hill, Woodcote Green & Clockhouse",381,208,566,380,381,439,550,510,497,522,462,425,381,262,329,5704,5912,6293
E02006836,Belmont & South Cheam,469,231,633,495,476,600,720,664,652,673,545,423,524,422,582,7409,7640,8109
E02000864,Bow North & Fish Island,514,233,1105,1627,2068,1505,1061,772,601,536,416,303,233,136,218,10581,10814,11328
E02000865,Bethnal Green North East,452,204,1043,1436,1342,965,726,578,452,377,308,222,157,114,140,7860,8064,8516
E02000866,Bow West,411,205,1039,1554,1711,1360,954,713,591,561,423,338,239,168,204,9855,10060,10471
E02000867,Bow South,434,205,1426,2381,2434,1921,1196,734,618,427,327,264,160,110,149,12147,12352,12786
E02000868,Bethnal Green North West,298,146,1067,1477,1595,1087,737,502,383,268,241,145,113,89,139,7843,7989,8287
E02000869,Columbia Road,293,106,673,1042,1072,798,563,431,381,311,256,158,150,88,137,6060,6166,6459
E02000870,Bethnal Green East,334,182,917,1154,1088,813,573,426,391,321,256,176,131,76,123,6445,6627,6961
E02000871,Bromley-by-Bow East,674,310,1697,2038,2091,1593,1172,837,621,471,345,255,164,93,179,11556,11866,12540
E02000872,Brick Lane North,381,182,1212,1900,1757,1222,783,508,398,334,247,175,98,68,108,8810,8992,9373
E02000873,Mile End West,437,270,4067,2336,1660,1189,871,663,391,328,239,171,113,80,130,12238,12508,12945
E02000874,Bethnal Green Central,421,205,1503,1593,1386,965,759,493,409,296,240,187,89,83,106,8109,8314,8735
E02000875,Bromley-by-Bow West,770,365,1771,2163,2194,1801,1203,879,691,549,387,271,178,115,136,12338,12703,13473
E02000876,Bethnal Green South,295,147,1371,2058,1680,1221,805,498,407,297,269,180,116,64,103,9069,9216,9511
E02000877,Mile End East & Burdett Estate,714,345,1838,2301,2529,1744,1211,912,641,404,370,236,151,124,172,12633,12978,13692
E02000878,Spitalfields,360,202,3550,3472,2559,1889,1141,776,553,428,383,268,143,105,168,15435,15637,15997
E02000879,Stepney Green,459,232,1413,1487,1426,1031,816,607,506,385,361,234,197,138,274,8875,9107,9566
E02000880,Whitechapel,353,169,1153,1227,1121,884,656,491,330,261,199,158,104,59,126,6769,6938,7291
E02000881,Poplar Leaside,663,323,1424,1794,1707,1284,902,595,521,450,341,238,156,85,123,9620,9943,10606
E02000882,Limehouse North & Stepney East,633,299,1303,1539,1603,1232,995,737,636,474,328,241,172,109,206,9575,9874,10507
E02000883,Poplar Central,566,266,1143,1286,1258,1075,837,622,551,384,338,247,158,101,140,8140,8406,8972
E02000884,Aldgate,521,272,3959,3466,2629,1792,1221,751,506,370,310,213,111,97,136,15561,15833,16354
E02000885,Shadwell North,443,214,1075,1135,1107,886,709,550,483,322,277,195,166,134,176,7215,7429,7872
E02000886,Limehouse East,368,156,1034,1584,1612,1207,849,621,486,394,267,223,151,72,97,8597,8753,9121
E02000887,Poplar West,600,308,1573,1718,1750,1376,1033,819,577,438,354,257,192,110,185,10382,10690,11290
E02000888,Shadwell Basin & Ratcliffe,420,187,1217,1630,1704,1213,969,681,492,369,273,189,129,69,110,9045,9232,9652
E02000889,St George in the East & Wapping North,406,139,1135,1733,1779,1281,934,626,450,346,293,223,124,85,105,9114,9253,9659
E02000890,Tower Hill & Wapping South,130,59,466,956,1121,902,708,516,421,396,329,206,160,79,104,6364,6423,6553
E02000891,Blackwall & Leamouth,769,355,3105,4841,4752,3242,1979,1282,851,609,430,292,180,126,130,21819,22174,22943
E02000893,Mudchute,338,166,911,1128,1276,1080,883,616,452,407,301,230,175,113,151,7723,7889,8227
E02000894,Millwall South,473,181,1342,1980,2316,2001,1503,907,578,523,380,245,202,116,130,12223,12404,12877
E02006853,Millwall North,495,227,1700,2457,2431,1692,1108,678,489,400,301,186,118,87,102,11749,11976,12471
E02006854,Canary Wharf,255,127,1189,1779,1693,1312,845,602,439,292,216,125,78,37,45,8652,8779,9034
E02000895,Chingford Green West,445,226,756,605,625,604,634,597,678,645,489,415,426,357,573,7404,7630,8075
E02000896,Chingford Green East,422,210,680,637,726,730,741,714,774,697,580,497,450,360,549,8135,8345,8767
E02000897,Friday Hill,485,224,720,578,732,690,736,666,692,668,501,365,329,261,472,7410,7634,8119
E02000898,Larkswood,408,209,616,583,633,678,564,606,641,649,498,375,356,288,394,6881,7090,7498
E02000899,Chingford Mount,473,218,752,668,745,769,708,694,662,677,541,412,331,266,421,7646,7864,8337
E02000900,South Chingford,566,261,858,763,822,773,761,635,695,681,518,385,306,249,301,7747,8008,8574
E02000901,Highams Park East,508,252,836,709,947,873,843,769,866,775,633,449,380,273,330,8683,8935,9443
E02000902,Highams Park West,594,289,875,756,923,983,901,817,719,604,490,297,270,195,249,8079,8368,8962
E02000903,Higham Hill,651,337,1037,914,1216,1125,985,808,761,630,495,333,226,165,194,8889,9226,9877
E02000904,Fulbourne Road & Walthamstow Forest,472,222,719,643,910,1027,924,680,660,570,430,305,214,158,190,7430,7652,8124
E02000905,Lloyd Park,569,262,830,867,1176,1299,1161,901,777,629,471,297,239,144,170,8961,9223,9792
E02000906,William Morris,575,259,828,847,1230,1256,1056,934,781,557,437,263,193,130,176,8688,8947,9522
E02000907,Wood Street,642,268,937,926,1328,1113,1058,809,729,624,441,288,231,173,265,8922,9190,9832
E02000908,Blackhorse Road,672,309,1262,1419,1823,1784,1309,1053,821,650,457,325,223,136,200,11462,11771,12443
E02000909,Upper Walthamstow,469,202,668,807,1089,1161,988,827,737,600,439,324,235,157,220,8252,8454,8923
E02000910,Walthamstow Central,491,208,888,1267,1738,1672,1221,953,862,677,500,366,274,165,281,10864,11072,11563
E02000911,Walthamstow Market & South Grove,622,279,1104,1454,1913,1823,1445,1101,953,750,486,365,238,176,210,12018,12297,12919
E02000912,Markhouse & St James Park,512,272,891,887,1085,1158,1006,828,726,600,431,321,220,191,198,8542,8814,9326
E02000913,Whipps Cross,514,224,912,968,1144,1156,1086,790,691,557,507,376,264,220,248,8919,9143,9657
E02000914,Baker's Arms,651,303,1144,1196,1565,1460,1284,1094,882,776,571,396,270,192,331,11161,11464,12115
E02000915,Leytonstone North,339,170,708,901,1268,1180,969,722,593,520,425,378,248,160,219,8291,8461,8800
E02000916,Lea Bridge,513,263,875,1046,1446,1436,1126,852,862,618,452,321,206,153,200,9593,9856,10369
E02000917,Leyton North,457,213,794,1052,1659,1500,1162,799,686,520,415,262,187,128,175,9339,9552,10009
E02000918,Leytonstone East,417,187,854,1002,1344,1340,1032,839,653,565,466,335,259,167,171,9027,9214,9631
E02000919,Leyton East,389,198,858,1301,1647,1448,1099,807,672,513,396,301,241,143,238,9664,9862,10251
E02000920,Leyton South,532,233,1093,1405,1711,1471,1080,916,768,662,481,357,228,173,227,10572,10805,11337
E02000921,Leytonstone South West,611,260,1152,1405,1665,1570,1170,940,902,734,547,362,305,200,201,11153,11413,12024
E02000922,Leytonstone South East,560,253,1067,1168,1545,1535,1231,932,769,692,510,360,251,163,232,10455,10708,11268
E02000923,Battersea Park,266,106,612,1086,1097,891,758,729,573,493,363,305,303,256,440,7906,8012,8278
E02000924,Nine Elms & Patmore,657,308,2122,3271,3208,2485,1848,1340,1066,924,674,446,290,210,254,18138,18446,19103
E02000925,Battersea Latchmere,407,172,835,1206,1101,881,856,700,658,549,389,261,193,150,188,7967,8139,8546
E02000926,St Mary's & Cotton Row,393,135,1070,2341,2212,1638,1391,996,784,648,449,343,348,208,234,12662,12797,13190
E02000927,Lavender Hill East,228,95,676,1419,1208,914,696,559,476,429,315,254,213,154,194,7507,7602,7830
E02000928,Putney Embankment & Lower Common,438,172,742,1201,1180,1103,1033,878,739,558,445,374,335,261,243,9092,9264,9702
E02000929,York Gardens,417,211,925,1237,1247,1028,782,652,567,501,349,253,202,146,210,8099,8310,8727
E02000930,Lavender Hill West & Little India,279,127,1535,2954,2353,1532,1020,691,598,433,309,208,197,132,166,12128,12255,12534
E02000931,Clapham Common West,394,144,799,1737,1439,1155,987,751,612,437,284,212,169,136,149,8867,9011,9405
E02000932,Putney Town & Wandsworth Park,441,180,961,2622,2667,2030,1777,1288,878,706,462,387,290,223,221,14512,14692,15133
E02000933,Putney West,430,179,836,1275,1373,1277,1186,927,746,653,524,397,385,282,345,10206,10385,10815
E02000934,Clapham Junction & East Hill,253,98,789,2172,1972,1330,1030,713,529,487,364,257,250,139,202,10234,10332,10585
E02000935,Roehampton North West,454,186,1575,918,776,707,659,531,449,368,307,212,182,151,235,7070,7256,7710
E02000936,East Putney,368,160,930,1776,1949,1695,1391,1110,795,599,453,310,325,246,330,11909,12069,12437
E02000937,Wandsworth Common,446,184,769,1086,1048,853,841,770,686,517,361,252,211,126,141,7661,7845,8291
E02000938,Roehampton North East,613,260,1071,1122,1319,1454,1328,1153,843,730,584,415,410,290,489,11208,11468,12081
E02000939,Nightingale Lane,476,177,676,998,782,739,779,715,656,489,385,276,225,185,282,7187,7364,7840
E02000940,Wandsworth South,400,167,774,1560,1830,1511,1132,771,593,453,336,262,197,149,162,9730,9897,10297
E02000941,Earlsfield North,432,205,1241,1879,1971,1637,1405,1092,914,684,461,312,281,184,225,12286,12491,12923
E02000942,Southfields North,539,215,927,1254,1304,1247,1043,937,773,668,473,386,332,264,270,9878,10093,10632
E02000943,Balham,318,132,796,1927,1662,1068,933,682,563,458,330,267,203,144,225,9258,9390,9708
E02000944,West Hill North,455,215,842,1004,1202,1056,952,711,562,487,336,232,197,139,211,7931,8146,8601
E02000945,Roehampton South & Putney Vale,471,212,1276,1049,976,954,851,675,549,470,387,285,235,161,186,8054,8266,8737
E02000946,Earlsfield South,306,176,690,1207,1335,1075,855,606,504,437,286,222,206,121,166,7710,7886,8192
E02000947,Merton Road,359,138,561,1098,1453,1372,1130,795,608,476,375,236,248,172,191,8715,8853,9212
E02000948,Tooting Bec Common,329,139,900,2374,1887,1289,1070,785,607,463,384,259,226,166,276,10686,10825,11154
E02000949,Springfield,387,170,840,1770,1532,1075,957,817,696,714,446,326,317,211,286,9987,10157,10544
E02000950,West Hill South,390,180,734,974,1036,1088,910,707,535,538,390,314,289,208,232,7955,8135,8525
E02000951,Tooting Bec West,246,107,568,1304,1177,694,586,517,453,416,302,223,165,106,163,6674,6781,7027
E02000952,Tooting Bec East,254,114,590,1262,948,704,569,511,504,419,294,219,181,125,147,6473,6587,6841
E02000953,Summerstown,231,104,761,1145,1375,1091,860,607,427,370,262,165,131,116,126,7436,7540,7771
E02000954,Upper Tooting,228,124,659,1112,936,771,673,488,442,387,280,230,187,143,227,6535,6659,6887
E02000955,Tooting North,308,140,695,1145,1060,875,741,537,465,443,320,241,224,131,228,7105,7245,7553
E02000956,Tooting West,304,127,963,1533,1398,1076,819,638,544,442,326,214,184,99,170,8406,8533,8837
E02000957,Tooting East,440,188,1006,1920,1951,1586,1168,1031,813,684,439,334,269,168,310,11679,11867,12307
E02000958,Furzedown West,510,231,954,848,859,791,760,703,665,601,432,365,295,200,318,7791,8022,8532
E02000959,Furzedown East,401,174,689,835,985,988,792,698,580,529,358,228,179,123,184,7168,7342,7743
E02000960,St John's Wood North,405,189,762,855,1001,919,850,796,634,562,428,323,322,227,384,8063,8252,8657
E02000961,Abbey Road,602,278,1115,1210,1388,1293,1177,1007,958,755,551,359,327,253,318,10711,10989,11591
E02000962,St John's Wood South,400,168,872,1235,1553,1277,1081,908,813,616,506,416,432,329,441,10479,10647,11047
E02000963,Queen's Park Gardens,479,273,1115,1056,1156,1080,952,903,898,871,602,448,330,255,288,9954,10227,10706
E02000964,Maida Hill,589,277,1285,1553,1782,1503,1305,1086,1079,948,693,528,367,266,325,12720,12997,13586
E02000965,Maida Vale,308,126,858,1253,1421,1362,1132,966,706,570,409,276,234,166,222,9575,9701,10009
E02000966,Little Venice,415,174,852,1082,1354,1313,1223,1056,889,813,582,466,370,242,275,10517,10691,11106
E02000967,Regent's Park,251,128,1409,1594,1434,1070,821,705,582,459,330,287,240,196,283,9410,9538,9789
E02000968,Church Street,762,420,2113,2037,1899,1436,1365,1240,1136,1047,812,632,472,336,512,15037,15457,16219
E02000969,Westbourne,599,291,1171,1281,1353,1166,1085,968,904,777,554,348,257,171,334,10369,10660,11259
E02000970,Marylebone & Park Lane,326,142,1140,1500,1389,1263,1067,1000,863,797,555,421,349,231,314,10889,11031,11357
E02000971,Bryanston & Dorset Square,269,127,1591,1683,1636,1171,979,848,671,613,458,315,282,233,245,10725,10852,11121
E02000972,Fitzrovia West & Soho,182,99,1760,1709,1593,1325,1047,872,790,670,510,328,250,176,201,11231,11330,11512
E02000973,Westbourne Grove,296,145,1029,1428,1761,1607,1367,1158,985,782,542,422,364,244,259,11948,12093,12389
E02000974,Paddington & St George's Fields,429,230,2230,1732,1574,1239,999,860,795,707,590,418,361,262,286,12053,12283,12712
E02000975,Bayswater East,240,94,1486,1915,1894,1469,1053,780,647,568,359,266,252,164,150,11003,11097,11337
E02000976,Queensway,310,150,1517,2120,2156,1708,1337,1082,837,721,508,361,312,253,267,13179,13329,13639
E02000977,"Strand, St James & Mayfair",135,99,2279,1806,1596,1284,1103,1020,931,746,490,363,274,180,225,12297,12396,12531
E02000978,"Knightsbridge, Belgravia & Hyde Park",299,213,3168,933,868,743,757,752,810,741,643,441,332,284,373,10845,11058,11357
E02000979,Central Westminster,320,260,1321,1480,1400,1141,1009,885,895,737,564,443,340,245,306,10766,11026,11346
E02000980,Millbank,362,151,1122,1417,1305,1095,879,783,808,678,566,410,330,268,324,9985,10136,10498
E02000981,Pimlico North,254,177,1151,1620,1453,1096,889,738,739,651,513,361,293,205,217,9926,10103,10357
E02000982,Victoria,353,202,933,1055,1083,919,835,751,697,585,479,376,326,234,278,8551,8753,9106
E02000983,Pimlico South,319,151,1009,1307,1095,937,732,659,661,605,478,329,295,221,347,8675,8826,9145
E02002483,Clavering,568,262,762,663,717,735,679,714,804,706,611,496,527,343,517,8274,8536,9104
E02002484,Headland & West View,605,233,853,719,795,666,652,608,727,837,726,553,531,310,494,8471,8704,9309
E02002485,Jesmond,484,209,721,558,626,590,470,473,585,603,530,391,401,290,303,6541,6750,7234
E02002487,Harbour & Victoria,202,99,453,404,405,418,369,339,375,355,324,251,212,132,141,4178,4277,4479
E02002488,Wooler Road,306,169,479,330,345,325,386,410,497,491,484,402,385,258,401,5193,5362,5668
E02002489,Old Town & Grange,407,214,769,508,558,576,482,450,536,552,471,395,342,204,296,6139,6353,6760
E02002490,Foggy Furze,286,159,494,460,522,426,360,380,426,474,439,344,270,170,184,4949,5108,5394
E02002491,Rift House & Summerhill,365,166,522,419,441,420,381,348,403,532,427,351,313,218,407,5182,5348,5713
E02002492,Rossmere & Mill,332,171,497,446,495,472,408,385,485,513,527,397,400,237,339,5601,5772,6104
E02002493,Seaton Carew,308,147,458,394,421,417,350,386,507,574,502,491,501,332,440,5773,5920,6228
E02002494,Owton Manor,456,214,654,582,627,581,430,422,537,553,481,369,329,231,301,6097,6311,6767
E02006909,"The Fens, Elwick & Hart",537,244,861,641,643,665,722,795,1066,1184,1079,924,912,664,823,10979,11223,11760
E02002496,Middlesbrough Central,667,319,3015,2688,2061,1599,1127,870,675,515,476,354,263,170,237,14050,14369,15036
E02002497,North Ormesby & Brambles,375,172,594,577,584,556,427,407,400,414,355,276,212,125,159,5086,5258,5633
E02002498,Ayresome,664,256,1630,1811,1641,1353,932,648,555,475,431,302,210,132,197,10317,10573,11237
E02002499,Berwick Hills,520,229,742,628,683,573,480,416,477,506,508,378,260,157,223,6031,6260,6780
E02002500,Linthorpe East & Albert Park,318,168,563,542,585,505,441,364,404,407,360,335,240,156,230,5132,5300,5618
E02002501,Park Vale,371,172,515,451,547,543,456,419,345,444,386,316,218,149,183,4972,5144,5515
E02002502,Thorntree,605,284,874,661,678,651,557,544,702,736,698,538,438,266,399,7742,8026,8631
E02002503,Newport & Maze Park,477,206,604,523,545,601,448,457,405,471,416,300,247,135,188,5340,5546,6023
E02002504,Linthorpe West,605,293,902,781,796,781,686,641,675,700,619,500,419,274,369,8143,8436,9041
E02002505,Park End,410,190,642,501,558,476,391,337,438,433,389,307,217,116,167,4972,5162,5572
E02002506,Beechwood & James Cook,331,160,487,476,501,427,352,333,409,399,332,220,219,144,218,4517,4677,5008
E02002507,Acklam,291,159,481,398,455,425,389,399,457,478,386,338,304,247,355,5112,5271,5562
E02002508,Kader,249,138,409,350,349,322,319,313,346,370,417,303,290,283,394,4465,4603,4852
E02002509,Easterside,268,143,372,373,420,381,307,234,301,443,434,310,284,174,280,4313,4456,4724
E02002510,Trimdon,277,132,390,455,544,530,393,382,410,484,455,451,488,381,439,5802,5934,6211
E02002512,Marton West,236,115,336,255,281,288,257,340,401,451,442,361,353,278,378,4421,4536,4772
E02002513,Stainton & Hemlington,508,238,732,730,742,652,601,623,652,695,682,660,607,351,489,8216,8454,8962
E02002514,Coulby Newham,443,216,604,511,515,576,518,558,679,781,687,569,511,328,460,7297,7513,7956
E02006811,Nunthorpe & Marton East,536,277,737,603,713,790,710,751,799,801,728,703,710,576,704,9325,9602,10138
E02002515,Redcar Town & Coatham,263,152,530,464,499,447,435,428,501,554,477,356,306,223,411,5631,5783,6046
E02002516,Redcar Lakes North,318,146,409,425,446,398,343,324,401,459,372,318,300,215,291,4701,4847,5165
E02002517,Dormanstown,262,138,464,358,372,363,299,311,393,441,393,268,276,208,296,4442,4580,4842
E02002518,Redcar East,454,222,778,599,706,687,583,645,870,998,862,694,673,492,598,9185,9407,9861
E02002519,Redcar Lakes South,412,181,550,427,490,472,471,454,463,518,523,471,462,367,502,6170,6351,6763
E02002520,Marske,599,263,863,632,644,726,749,826,1030,1093,962,831,953,822,961,11092,11355,11954
E02002521,Saltburn,248,126,348,237,281,338,334,423,495,554,461,447,469,381,576,5344,5470,5718
E02002523,Grangetown,388,168,618,507,541,542,371,377,422,400,340,276,207,113,144,4858,5026,5414
E02002524,Brotton,286,122,410,277,301,309,308,347,408,416,404,330,389,271,294,4464,4586,4872
E02002525,Eston,321,162,559,463,507,457,419,447,619,680,681,541,467,406,534,6780,6942,7263
E02002526,Skelton,399,183,526,458,448,459,466,486,597,587,579,496,490,332,303,6227,6410,6809
E02002527,Loftus & Skinningrove,272,127,390,326,338,310,272,307,353,380,312,292,280,188,210,3958,4085,4357
E02002529,Bankfields,284,135,469,336,341,326,351,361,471,493,454,325,395,278,278,4878,5013,5297
E02002530,"Boosbeck, Lingdale & Easington",259,147,393,336,329,352,316,355,496,535,457,420,454,330,362,5135,5282,5541
E02002532,Guisborough North,313,137,489,484,460,413,409,442,525,540,496,391,424,286,457,5816,5953,6266
E02002533,Guisborough West,324,141,421,347,424,430,385,413,469,491,456,499,517,363,427,5642,5783,6107
E02002534,Guisborough Outer & Upleatham,209,104,299,256,230,250,271,307,372,466,445,434,545,437,519,4831,4935,5144
E02006812,Ormesby,356,176,531,460,505,479,425,413,571,627,536,480,464,358,520,6369,6545,6901
E02006910,South Bank & Teesville,551,251,822,781,868,759,640,604,793,849,733,640,540,397,542,8968,9219,9770
E02002535,Billingham North & Wolviston,398,208,621,583,563,507,539,606,753,856,793,674,599,372,461,7927,8135,8533
E02002536,Billingham Central,467,209,676,547,652,648,533,483,685,723,713,543,482,386,546,7617,7826,8293
E02002537,Billingham East & Haverton Hill,479,210,716,613,688,643,498,481,526,686,528,384,319,242,380,6704,6914,7393
E02002538,Billingham South,296,141,388,372,405,358,358,374,373,447,402,323,329,232,241,4602,4743,5039
E02002539,"Billingham West, Stillington & Longnewton",515,227,624,518,626,645,642,721,831,885,835,682,684,529,546,8768,8995,9510
E02002540,Norton North,241,117,320,296,354,363,320,392,435,454,471,494,559,364,444,5266,5383,5624
E02002541,Norton High Street,291,136,382,406,380,379,363,395,454,452,440,358,367,230,364,4970,5106,5397
E02002542,Roseworth,488,229,687,592,637,609,483,468,544,593,533,394,394,211,300,6445,6674,7162
E02002543,Hardwick & Salters Lane,531,235,701,708,777,734,595,499,583,630,556,402,348,168,299,7000,7235,7766
E02002544,Norton South,410,161,782,961,936,829,690,533,578,574,546,409,347,224,337,7746,7907,8317
E02002545,Rimswell & Bishopsgarth,193,83,334,297,293,301,289,285,360,403,417,369,402,279,327,4356,4439,4632
E02002546,Eastbourne & Newham Grange,428,190,695,546,596,565,485,444,548,549,448,365,268,191,260,5960,6150,6578
E02002547,Elm Tree & Grangefield,278,124,375,281,333,311,311,358,413,505,520,475,490,347,498,5217,5341,5619
E02002548,"Central Stockton, Portrack & Low Hartburn",688,349,1702,1440,1458,1309,1074,874,937,853,689,544,380,221,275,11756,12105,12793
E02002549,Fairfield,350,146,419,399,422,411,408,415,559,593,529,503,547,494,613,6312,6458,6808
E02002550,Hartburn,284,139,439,355,386,437,399,377,480,498,462,372,300,245,357,5107,5246,5530
E02002551,Thornaby North,263,141,1114,854,789,563,420,355,352,348,289,303,208,137,203,5935,6076,6339
E02002552,Thornaby Mandale,404,188,535,461,549,570,486,386,488,526,441,398,379,210,219,5648,5836,6240
E02002553,Thornaby Village,298,125,373,352,424,435,357,332,412,386,339,340,333,230,318,4631,4756,5054
E02002554,Thornaby South,278,122,395,364,362,375,302,296,342,354,361,347,330,253,299,4380,4502,4780
E02002555,Eaglescliffe,585,250,637,518,590,624,688,789,772,732,670,600,644,484,651,8399,8649,9234
E02002556,Ingleby Barwick East & Hilton,353,193,551,375,446,443,428,457,584,638,589,519,444,240,232,5946,6139,6492
E02002557,Ingleby Barwick West,1255,525,1400,949,1030,1284,1462,1482,1514,1045,781,497,399,235,286,12364,12889,14144
E02002558,Yarm,554,246,664,589,715,817,843,758,832,840,814,747,794,557,639,9609,9855,10409
E02002559,"Faverdale, Heighington & Sadberge",553,249,661,487,552,578,662,774,845,801,677,574,581,412,381,7985,8234,8787
E02002560,Harrowgate Hill,346,187,466,357,456,397,382,469,544,435,423,329,332,240,279,5109,5296,5642
E02002561,Whinfield,242,122,348,301,325,287,297,331,399,471,430,449,458,256,305,4657,4779,5021
E02002562,Rise Carr,237,109,448,454,446,424,349,366,493,451,392,308,251,184,276,4842,4951,5188
E02002563,Haughton Le Skerne,250,108,407,278,340,320,348,330,379,419,407,404,388,257,415,4692,4800,5050
E02002564,Cockerton & Hopetown,525,254,775,603,679,625,616,653,749,794,648,483,495,363,463,7946,8200,8725
E02002565,Pierremont,195,93,370,420,439,376,328,350,378,413,373,242,250,166,183,4288,4381,4576
E02002566,Central Darlington,260,137,637,636,683,624,583,484,454,479,387,262,231,158,207,5825,5962,6222
E02002567,Albert Hill & Red Hall,505,244,758,757,828,728,614,517,540,590,535,442,429,305,403,7446,7690,8195
E02002568,College & Park West,327,158,400,262,265,333,406,425,537,487,456,379,400,304,498,5152,5310,5637
E02002569,Hummersknott,432,220,545,321,374,443,540,559,709,722,672,642,725,610,963,7825,8045,8477
E02002570,Bank Top,362,149,692,646,620,601,527,496,539,586,520,443,401,272,464,6807,6956,7318
E02002571,Firthmoor,327,162,491,490,548,483,456,385,454,438,371,291,271,224,282,5184,5346,5673
E02002572,Park East,358,187,599,458,545,510,487,427,455,460,341,300,263,166,189,5200,5387,5745
E02002573,Middleton & Hurworth,521,221,605,482,536,631,611,648,751,719,672,614,606,468,590,7933,8154,8675
E02004290,Ouston & Beamish,242,110,361,320,321,305,350,371,477,518,431,422,383,302,322,4883,4993,5235
E02004291,Pelton & Perkinsville,299,166,515,494,545,514,447,455,553,605,484,372,378,261,350,5973,6139,6438
E02004292,Chester-le-Street North,369,161,524,446,453,421,489,501,636,665,561,486,521,525,663,6891,7052,7421
E02004293,Chester-le-Street Town & Pelton Fell,468,220,813,686,716,698,552,618,777,787,579,511,435,386,551,8109,8329,8797
E02004294,Chester-le-Street South & East,357,158,540,370,400,407,441,536,738,770,677,573,564,434,507,6957,7115,7472
E02004295,Great Lumley & Bournmoor,371,148,516,387,388,416,403,511,632,625,507,495,503,342,443,6168,6316,6687
E02004296,Sacriston,367,194,665,541,608,616,543,532,711,702,581,493,479,312,384,7167,7361,7728
E02004297,Burnopfield,354,143,488,442,482,501,483,512,601,665,603,470,470,384,497,6598,6741,7095
E02004298,"Benfieldside, Hamsterley & Medomsley",426,185,623,498,565,598,602,661,747,865,742,701,641,456,627,8326,8511,8937
E02004299,Stanley North & East,415,168,556,507,530,522,508,508,625,636,626,575,519,365,421,6898,7066,7481
E02004300,Catchgate & Dipton,374,158,497,469,531,503,435,449,571,613,524,467,498,357,391,6305,6463,6837
E02004301,Stanley South,556,248,814,680,700,647,600,600,718,650,586,492,445,306,343,7581,7829,8385
E02004302,Stanley West & Annfield Plain,356,154,611,536,601,561,459,497,593,578,479,448,419,323,332,6437,6591,6947
E02004303,Consett,486,236,826,690,720,752,687,825,910,916,794,639,625,450,594,9428,9664,10150
E02004304,Delves Lane & Leadgate,449,194,648,505,602,627,594,576,666,671,589,460,454,348,519,7259,7453,7902
E02004305,"Bridgehill, Castleside & Harehope Hill",523,211,798,693,755,727,677,660,749,706,613,518,486,325,408,8115,8326,8849
E02004306,Lanchester,266,119,355,250,350,372,355,383,448,494,429,454,459,353,402,5104,5223,5489
E02004307,Langley Park & Satley,268,131,493,369,422,414,409,406,525,569,539,404,383,254,290,5477,5608,5876
E02004308,Newton Hall & Brasside,304,152,462,402,565,661,641,549,604,630,567,559,608,460,423,7131,7283,7587
E02004309,Pity Me & Framwellgate Moor,293,150,438,443,512,452,438,459,466,454,400,378,363,253,385,5441,5591,5884
E02004310,Bearpark & Witton Gilbert,345,184,550,482,497,505,491,487,634,592,493,497,489,359,352,6428,6612,6957
E02004311,Sherburn & West Rainton,397,199,642,539,557,580,549,560,759,741,694,569,579,404,457,7630,7829,8226
E02004312,Belmont & Carrville,282,149,395,362,441,480,466,442,488,506,482,502,652,513,645,6374,6523,6805
E02004313,Gilesgate & Old Durham,287,128,1598,950,716,507,424,329,395,378,344,268,274,205,246,6634,6762,7049
E02004314,Durham City,62,84,13449,2680,1357,464,299,219,198,203,196,171,192,136,301,19865,19949,20011
E02004315,"Aykley Heads, Neville's Cross & Langley Moor",637,326,3842,1294,980,909,911,813,777,727,591,531,491,343,449,12658,12984,13621
E02004316,Esh Winning & Ushaw Moor,289,145,404,388,457,451,416,390,508,475,433,379,334,238,272,5145,5290,5579
E02004317,Brandon & Brancepeth,299,171,537,374,461,461,465,443,541,588,566,492,510,331,405,6174,6345,6644
E02004318,High Shincliffe & Bowburn,305,139,476,460,563,472,489,396,457,521,467,416,376,294,343,5730,5869,6174
E02004319,Coxhoe & Quarrington Hill,346,182,602,529,562,517,465,503,691,641,510,425,424,317,378,6564,6746,7092
E02004320,Seaham Northlea & Westlea,390,194,536,460,483,583,606,553,639,734,701,574,486,340,472,7167,7361,7751
E02004321,Seaham Central & South,372,189,593,484,637,597,511,488,618,632,668,480,373,294,483,6858,7047,7419
E02004322,Murton North & Parkside,457,236,701,620,621,573,527,559,597,587,537,535,500,346,435,7138,7374,7831
E02004323,South Murton & South Hetton,362,156,533,483,550,538,482,489,557,629,548,376,360,261,333,6139,6295,6657
E02004324,Easington & Hawthorn,276,121,419,371,402,411,380,389,444,432,440,348,348,252,275,4911,5032,5308
E02004325,Peterlee East,493,232,816,658,685,656,571,563,698,678,559,432,385,251,378,7330,7562,8055
E02004326,Shotton & Haswell,349,157,552,501,525,411,435,420,499,547,453,360,334,251,301,5589,5746,6095
E02004327,Horden,236,113,479,348,400,378,340,352,434,433,436,344,330,285,357,4916,5029,5265
E02004328,Peterlee West,391,216,596,500,525,539,498,454,565,505,478,327,310,268,370,5935,6151,6542
E02004329,Peterlee South,258,169,500,402,355,364,363,392,526,558,530,506,415,315,368,5594,5763,6021
E02004330,Blackhall,224,114,456,372,357,384,345,338,431,486,515,443,392,302,413,5234,5348,5572
E02004331,Thornley & Wheatley Hill,323,151,520,473,482,467,416,444,578,557,504,357,390,346,356,5890,6041,6364
E02004332,Wingate & Castle Eden,378,182,543,444,481,503,472,477,584,630,553,421,367,260,316,6051,6233,6611
E02004333,Tudhoe Grange,251,137,429,321,398,400,380,403,495,538,506,588,555,403,357,5773,5910,6161
E02004334,Trimdon & Fishburn,340,170,534,425,421,404,406,456,559,594,521,428,390,302,286,5726,5896,6236
E02004335,Spennymoor East & Ferryhill West,335,137,598,614,648,571,488,465,512,500,405,421,382,267,299,6170,6307,6642
E02004336,Ferryhill East & Cornforth,291,135,472,378,454,402,375,396,522,561,507,477,441,368,428,5781,5916,6207
E02004337,Spennymoor West,518,235,806,630,702,750,743,717,793,723,719,601,628,353,447,8612,8847,9365
E02004338,Chilton,316,161,578,491,508,469,428,462,598,595,511,409,408,302,315,6074,6235,6551
E02004339,Sedgefield & Bishop Middleham,345,176,378,329,357,396,444,506,517,555,483,483,530,450,460,5888,6064,6409
E02004340,Shildon,527,239,794,707,745,719,606,646,762,861,731,577,636,367,534,8685,8924,9451
E02004341,Newton Aycliffe North,410,209,621,551,522,528,496,560,704,841,683,578,587,419,420,7510,7719,8129
E02004342,Newton Aycliffe West,380,174,544,442,414,404,392,344,328,354,264,232,218,168,239,4343,4517,4897
E02004343,Newton Aycliffe East,272,126,414,367,352,328,340,325,398,439,405,335,322,213,381,4619,4745,5017
E02004344,Newton Aycliffe South,323,173,477,402,486,441,401,390,522,623,547,478,473,313,457,6010,6183,6506
E02004345,"Evenwood, Cockfield & Staindrop",571,300,828,612,655,611,671,836,1092,1179,1033,1036,961,709,830,11053,11353,11924
E02004346,Upper Teesdale,222,105,280,182,206,200,232,304,435,539,519,404,468,301,299,4369,4474,4696
E02004347,Barnard Castle,346,162,779,358,341,332,359,363,506,592,555,490,540,393,641,6249,6411,6757
E02004348,Stanhope & Weardale,327,148,424,263,298,363,383,537,680,750,729,647,696,497,552,6819,6967,7294
E02004349,Crook North & Tow Law,462,234,694,533,610,587,547,570,700,689,597,547,499,348,449,7370,7604,8066
E02004350,Crook South,463,231,574,487,585,603,612,626,764,745,737,662,661,458,554,8068,8299,8762
E02004351,Coundon North,383,185,547,424,483,421,404,440,575,601,537,432,425,273,346,5908,6093,6476
E02004352,Bishop Auckland North & Coundon Grange,363,202,645,579,576,548,505,532,667,661,533,469,428,299,431,6873,7075,7438
E02004353,Bishop Auckland Central & West,348,168,538,383,439,383,415,428,615,662,537,451,507,365,534,6257,6425,6773
E02004354,Saint Helen Auckland & West Auckland,473,217,682,513,594,662,586,608,709,742,620,576,593,369,362,7616,7833,8306
E02004355,Bishop Auckland South,405,224,664,476,475,491,465,446,506,550,500,427,416,243,320,5979,6203,6608
E02005702,Longhoughton & Alnmouth,268,121,443,325,327,350,311,411,532,583,634,486,592,416,607,6017,6138,6406
E02005703,Alnwick,311,131,479,358,403,387,425,393,479,527,548,542,498,350,494,5883,6014,6325
E02005704,"Amble, Shilbottle & Swarland",513,225,771,603,629,593,580,693,999,1214,1236,1081,1053,746,868,11066,11291,11804
E02005705,Rothbury & Longframlington,305,127,398,230,259,283,367,402,606,769,768,761,699,506,545,6593,6720,7025
E02005706,Berwick-upon-Tweed Town,418,212,648,517,661,620,564,536,614,720,702,628,630,435,642,7917,8129,8547
E02005707,Berwick-upon-Tweed West & Holy Island,287,119,431,313,296,332,325,391,512,651,643,583,680,532,576,6265,6384,6671
E02005708,"Seahouses, Belford & Wooler",325,145,497,391,477,412,422,470,676,999,996,1000,990,698,836,8864,9009,9334
E02005709,Blyth Cowpen,371,188,604,531,533,541,376,349,482,470,377,327,328,238,284,5440,5628,5999
E02005710,Blyth Town,373,201,702,560,644,707,595,634,665,683,612,548,529,360,514,7753,7954,8327
E02005711,Blyth Isabella,408,192,653,476,513,473,423,504,534,579,511,500,507,347,386,6406,6598,7006
E02005712,Blyth Newsham,453,218,711,715,717,637,565,570,601,618,546,430,402,272,289,7073,7291,7744
E02005713,Blyth South,262,130,384,294,326,347,366,412,456,500,555,513,541,349,296,5339,5469,5731
E02005714,North Cramlington,274,188,440,234,216,236,300,465,534,416,383,377,355,209,128,4293,4481,4755
E02005715,Cramlington Town & Beaconhill,507,198,698,686,659,642,645,616,678,601,544,530,523,377,489,7688,7886,8393
E02005716,East Cramlington & Parkside,434,232,676,620,661,685,706,658,674,649,649,597,657,351,345,7928,8160,8594
E02005717,Holywell & Hartley,309,143,453,314,377,420,466,458,568,598,651,566,605,491,563,6530,6673,6982
E02005718,Cramlington South,209,108,369,319,342,319,359,373,418,488,457,529,696,505,431,5605,5713,5922
E02005719,Seaton Delaval & Seghill,293,148,585,527,566,496,520,544,616,608,557,524,526,352,374,6795,6943,7236
E02005720,"Widdrington, Lynemouth & Hadston",417,211,835,894,1053,890,728,744,878,1004,998,926,831,574,564,10919,11130,11547
E02005721,Morpeth North & Pegswood,255,138,363,244,289,367,315,362,426,494,503,402,347,227,330,4669,4807,5062
E02005722,"Longhorsley, Hepscott & Capheaton",393,193,603,500,463,574,577,623,737,899,849,729,631,426,466,8077,8270,8663
E02005723,Morpeth Central & East,248,119,364,290,333,328,364,345,418,473,508,456,451,347,580,5257,5376,5624
E02005724,Morpeth South & West,326,137,401,248,298,357,392,438,462,508,516,444,574,398,591,5627,5764,6090
E02005725,Ponteland,343,152,446,295,351,417,429,418,495,549,552,486,570,444,755,6207,6359,6702
E02005726,"Darras Hall, Stamfordham & Heddon",345,191,632,430,405,519,576,472,605,684,593,543,581,450,642,7132,7323,7668
E02005727,"Bellingham, Otterburn & Redesdale",211,131,304,245,269,313,311,375,494,601,625,527,471,337,392,5264,5395,5606
E02005728,Haltwhistle & Bardon Mill,273,135,394,288,343,342,304,359,504,594,604,540,582,417,460,5731,5866,6139
E02005729,Wylam & Ovingham,255,123,354,212,255,299,345,371,503,488,476,377,430,316,400,4826,4949,5204
E02005730,Hexham & Acomb,547,308,799,591,699,629,699,744,1005,1046,1062,958,976,741,1076,11025,11333,11880
E02005731,Prudhoe,549,289,860,589,676,645,677,798,886,947,733,601,666,451,557,9086,9375,9924
E02005732,"Stocksfield, Riding Mill & Corbridge",376,187,467,334,367,417,489,570,632,755,792,743,765,608,854,7793,7980,8356
E02005733,Haydon Bridge & Allendale,328,164,474,384,372,383,425,508,613,778,799,714,699,484,518,7151,7315,7643
E02005734,Newbiggin,264,118,423,345,351,334,325,360,413,495,480,460,426,282,370,5064,5182,5446
E02005735,Ashington Hirst,336,186,657,598,572,503,450,528,559,516,432,343,333,237,313,6041,6227,6563
E02005736,Ashington East,452,187,671,553,632,583,551,572,606,580,510,477,487,335,309,6866,7053,7505
E02005737,Ashington West,327,154,516,486,487,492,395,454,533,642,565,510,471,341,371,6263,6417,6744
E02005738,Ashington South,228,104,376,293,278,301,285,350,386,415,365,338,342,255,235,4219,4323,4551
E02005739,Guide Post & Stakeford,365,173,665,523,520,521,501,538,752,741,692,604,577,473,637,7744,7917,8282
E02005740,Bedlington Station & Sleekburn,470,237,759,584,660,637,596,650,724,785,690,587,606,390,504,8172,8409,8879
E02005741,Bedlington Town,410,193,604,468,512,456,476,523,698,781,657,581,578,377,535,7246,7439,7849
E02001708,Kingston Park & Dinnington,760,329,909,1102,1523,1473,1372,1073,912,958,862,751,679,392,521,12527,12856,13616
E02001709,North Gosforth,558,247,671,681,691,779,770,794,770,732,661,637,617,463,633,8899,9146,9704
E02001710,Fawdon South,507,230,829,777,769,778,722,631,680,777,717,561,463,331,516,8551,8781,9288
E02001711,Woolsington & Airport,518,234,968,843,847,793,637,625,643,736,704,462,446,331,558,8593,8827,9345
E02001712,South Gosforth,382,190,832,837,890,860,702,625,657,656,552,535,523,318,550,8537,8727,9109
E02001713,Coxlodge & West Gosforth,472,224,726,683,775,794,760,742,752,838,659,618,523,387,580,8837,9061,9533
E02001714,High Heaton,482,239,687,626,791,862,774,687,716,720,685,598,496,280,432,8354,8593,9075
E02001715,Kenton,767,288,1014,802,987,996,875,818,814,736,655,531,478,307,408,9421,9709,10476
E02001718,Blakelaw,346,168,552,525,548,510,415,448,469,475,408,324,304,217,261,5456,5624,5970
E02001719,North Heaton,382,177,626,779,799,695,653,535,619,624,581,497,430,302,453,7593,7770,8152
E02001720,North Jesmond,116,62,3203,930,573,479,348,275,285,311,327,278,241,165,213,7628,7690,7806
E02001721,Throckley & Newburn,511,223,779,725,810,769,666,657,797,865,778,581,602,435,646,9110,9333,9844
E02001722,Denton,503,227,699,629,697,648,577,508,608,716,612,469,442,349,655,7609,7836,8339
E02001723,Cowgate,445,183,618,516,602,694,569,487,457,400,395,276,240,166,283,5703,5886,6331
E02001724,South Jesmond & Sandyford,96,56,2656,1170,826,602,369,300,317,302,243,238,243,180,297,7743,7799,7895
E02001725,Heaton South,212,101,1711,1913,1588,1007,669,510,451,399,296,229,221,134,208,9336,9437,9649
E02001726,Fenham,685,312,1230,956,1077,970,851,800,824,844,721,549,466,315,446,10049,10361,11046
E02001727,Walkergate,402,154,681,644,699,645,493,491,643,752,665,575,450,323,443,7504,7658,8060
E02001728,Lemington,478,217,724,610,677,710,566,600,637,722,650,515,564,387,432,7794,8011,8489
E02001729,Nunsmoor,670,310,3351,2497,2460,1910,1291,907,699,580,434,320,206,133,252,15040,15350,16020
E02001730,Shieldfield & Heaton Park,187,121,7706,4066,2214,1097,685,504,497,468,373,314,232,155,178,18489,18610,18797
E02001731,City Centre & Arthur's Hill,356,245,11546,6911,3542,1618,933,755,608,556,412,342,266,153,245,27887,28132,28488
E02001732,Scotswood,326,153,420,397,501,481,371,349,367,383,390,289,277,142,181,4548,4701,5027
E02001733,Byker,676,284,1214,1210,1293,1115,937,840,874,878,701,585,488,319,433,10887,11171,11847
E02001734,Benwell,503,261,772,709,802,731,685,612,502,530,507,350,345,244,359,7148,7409,7912
E02001735,Walker North,429,195,664,501,554,530,442,435,461,457,393,277,236,157,277,5384,5579,6008
E02001736,Elswick,1074,421,1936,1597,1808,1717,1510,1272,1071,749,692,475,358,208,310,13703,14124,15198
E02001737,Walker South,319,142,516,505,556,519,430,408,423,426,386,293,267,198,279,5206,5348,5667
E02006893,Westerhope,381,177,691,585,652,700,599,575,753,827,880,719,880,689,923,9473,9650,10031
E02001738,Whitley Bay North,296,152,321,217,209,330,465,414,440,459,398,435,532,439,572,5231,5383,5679
E02001739,Fordley,323,177,510,474,475,421,387,473,572,636,545,482,515,354,340,6184,6361,6684
E02001740,Whitley Sands,391,158,358,197,238,358,488,487,470,439,401,335,357,271,371,4770,4928,5319
E02001741,Wideopen & Seaton Burn,268,147,444,389,539,494,437,471,537,579,557,554,600,417,604,6622,6769,7037
E02001742,West Monkseaton,260,105,380,259,297,343,413,393,507,459,405,390,457,321,405,5029,5134,5394
E02001743,Whitley Bay Promenade,345,178,516,373,476,602,677,639,624,623,524,440,397,262,338,6491,6669,7014
E02001744,Shiremoor North & South Wellfield,368,166,461,541,708,671,622,552,519,570,489,394,367,247,369,6510,6676,7044
E02001745,Killingworth West & Camperdown,366,149,471,452,513,508,483,406,469,457,458,381,366,250,251,5465,5614,5980
E02001746,Monkseaton,434,226,626,409,492,529,628,605,691,589,549,426,473,334,462,6813,7039,7473
E02001747,Cullercoats,227,106,295,263,347,402,422,388,433,508,448,454,455,352,579,5346,5452,5679
E02001748,Shiremoor South & West Allotment,472,211,643,552,681,716,696,652,656,521,486,407,376,199,279,6864,7075,7547
E02001749,Killingworth East,299,132,377,338,362,465,420,429,412,491,456,413,480,255,355,5253,5385,5684
E02001750,Preston Grange,308,151,447,331,357,457,463,415,529,537,440,468,441,325,526,5736,5887,6195
E02001751,Forest Hall & West Moor,274,145,467,451,512,493,473,427,481,469,436,379,328,263,339,5518,5663,5937
E02001752,New York,382,148,538,409,508,482,385,446,471,423,301,326,308,229,298,5124,5272,5654
E02001753,Tynemouth Priory,258,103,285,314,344,415,418,463,474,480,445,444,436,290,376,5184,5287,5545
E02001754,Tynemouth West,207,91,327,295,365,400,373,384,436,490,449,376,366,278,430,4969,5060,5267
E02001755,Holystone & Benton,403,222,607,562,771,774,710,658,652,756,592,530,470,347,488,7917,8139,8542
E02001756,Longbenton,459,189,664,751,939,880,753,550,601,651,570,472,384,256,380,7851,8040,8499
E02001757,Preston Billy Mill,239,124,360,328,367,375,328,378,452,549,469,391,389,259,382,5027,5151,5390
E02001758,Battle Hill East,254,118,380,297,390,388,421,355,360,371,428,401,384,234,174,4583,4701,4955
E02001759,North Shields,198,112,401,415,488,487,391,481,474,493,462,363,342,218,350,5365,5477,5675
E02001760,Chirton,509,208,677,621,677,585,494,478,556,540,457,336,266,202,232,6121,6329,6838
E02001761,Battle Hill West,221,103,387,334,356,402,374,293,356,388,390,372,337,302,347,4638,4741,4962
E02001762,East Benton,239,113,430,557,570,498,396,346,397,501,534,473,350,238,215,5505,5618,5857
E02001763,Howdon,297,138,558,471,447,438,402,423,468,504,458,387,334,230,242,5362,5500,5797
E02001764,Percy Main,385,186,596,538,626,550,538,523,614,617,516,447,380,210,307,6462,6648,7033
E02001765,Willington Quay,429,178,633,492,637,633,584,523,496,456,439,420,293,216,320,6142,6320,6749
E02001766,Wallsend East,360,201,596,629,655,621,619,487,521,520,432,371,275,175,196,6097,6298,6658
E02001767,Wallsend West,295,154,502,489,545,515,472,447,512,603,496,400,353,248,346,5928,6082,6377
E02001768,South Shields East,405,198,672,567,618,654,705,671,657,660,629,514,420,289,335,7391,7589,7994
E02001769,South Shields West,294,141,673,897,1004,882,801,698,657,611,565,442,362,217,299,8108,8249,8543
E02001770,Westoe,208,105,484,487,557,493,536,515,533,554,520,383,323,253,362,6000,6105,6313
E02001771,Horsley Hill,326,149,426,360,405,403,399,370,439,496,499,407,360,277,406,5247,5396,5722
E02001772,West Park,236,92,390,344,404,380,365,357,405,385,369,316,298,251,359,4623,4715,4951
E02001773,Harton West,219,107,322,255,272,300,304,287,358,466,495,438,424,310,421,4652,4759,4978
E02001774,Jarrow Town,229,108,398,381,409,385,338,347,410,439,371,315,320,222,237,4572,4680,4909
E02001775,Harton East,308,143,418,359,390,369,358,325,417,394,367,330,339,208,332,4606,4749,5057
E02001776,Hebburn North,398,206,649,623,728,726,588,551,628,675,581,502,400,230,385,7266,7472,7870
E02001777,Hebburn West,256,135,481,479,499,555,451,399,526,557,469,358,331,218,272,5595,5730,5986
E02001778,West Harton,206,119,430,491,505,421,372,378,444,475,405,321,302,187,291,5022,5141,5347
E02001779,Simonside,265,122,456,368,419,401,328,315,372,408,382,335,303,208,261,4556,4678,4943
E02001780,Cleadon Park,283,155,391,385,475,447,345,342,414,446,458,339,393,288,313,5036,5191,5474
E02001781,Brockley Whins,255,119,394,373,480,391,291,287,362,432,386,307,253,144,210,4310,4429,4684
E02001782,Hebburn South,517,231,708,615,792,783,648,626,672,685,672,569,460,344,551,8125,8356,8873
E02001783,Biddick Hill,416,178,616,575,659,541,435,397,494,477,445,303,304,166,266,5678,5856,6272
E02001784,Primrose,366,156,554,400,447,429,396,399,541,523,458,394,346,282,358,5527,5683,6049
E02001785,Whitburn & Marsden,381,156,515,398,418,408,436,482,567,648,620,539,563,409,483,6486,6642,7023
E02001786,Whiteleas,314,149,483,440,481,482,401,348,499,582,521,422,344,244,375,5622,5771,6085
E02001787,Fellgate & Hedworth,279,102,384,279,339,341,288,361,424,421,346,346,417,279,264,4489,4591,4870
E02001788,Boldon Colliery,260,113,422,369,472,382,336,350,466,506,446,388,340,186,284,4947,5060,5320
E02001789,Cleadon & East Boldon,235,119,343,254,250,310,355,390,425,543,462,400,437,337,496,5002,5121,5356
E02001790,West Boldon,306,141,416,284,346,365,361,385,499,450,437,364,380,262,436,4985,5126,5432
E02001791,Fulwell,196,88,353,301,351,335,309,293,435,494,466,312,324,269,421,4663,4751,4947
E02001792,Seaburn,251,171,437,340,361,373,386,450,544,671,604,515,457,355,624,6117,6288,6539
E02001793,Town End Farm,444,209,726,614,673,581,506,505,601,647,566,369,309,211,359,6667,6876,7320
E02001794,Hylton Red House & Marley Pots,434,204,702,581,670,661,541,535,609,635,574,449,417,339,507,7220,7424,7858
E02001795,Southwick,355,149,534,488,582,558,474,448,503,624,560,478,455,262,363,6329,6478,6833
E02001796,Monkwearmouth,296,140,790,900,822,783,602,576,710,710,697,538,564,370,546,8608,8748,9044
E02001797,Springwell & Usworth,265,131,433,311,345,330,372,436,489,458,397,401,434,297,337,5040,5171,5436
E02001798,North Hylton,428,177,659,556,625,513,495,537,656,633,617,468,414,292,353,6818,6995,7423
E02001799,Concord and Sulgrave,508,238,782,706,744,680,658,556,714,622,598,509,449,274,416,7708,7946,8454
E02001800,Albany and Blackfell,344,173,543,384,431,436,419,471,515,455,482,482,494,267,259,5638,5811,6155
E02001801,Millfield,311,149,834,987,828,641,449,488,489,395,380,271,232,116,174,6284,6433,6744
E02001802,Pallion North,399,192,573,603,670,536,456,423,510,511,424,330,304,209,301,5850,6042,6441
E02001803,Sunderland Central & Deptford,295,164,1831,1397,1389,1060,762,646,620,575,466,364,324,188,268,9890,10054,10349
E02001804,South Hylton,300,141,490,409,473,448,370,387,471,490,431,335,335,266,357,5262,5403,5703
E02001805,Pallion South & High Barnes,210,95,368,337,421,369,303,357,422,443,442,381,336,262,457,4898,4993,5203
E02001806,Hendon & Docks,401,197,752,694,751,696,596,596,660,622,605,472,400,241,320,7405,7602,8003
E02001807,"Columbia, Barmston & Teal Farm",459,198,580,534,655,607,649,579,603,566,488,462,449,275,335,6782,6980,7439
E02001808,Barnes Park,304,132,586,584,605,526,442,417,456,391,339,310,232,179,256,5323,5455,5759
E02001809,Washington Town Centre & Biddick,306,137,406,324,380,427,436,424,403,444,457,522,578,350,335,5486,5623,5929
E02001810,Oxclose and Lambton,373,165,631,449,571,597,606,553,583,591,629,656,602,305,259,7032,7197,7570
E02001811,Pennywell and Grindon,469,212,665,602,631,629,532,541,686,650,591,453,475,343,422,7220,7432,7901
E02001812,Hill View & Tunstall,392,213,654,553,589,551,597,630,755,848,800,740,719,538,807,8781,8994,9386
E02001813,Thorney Close & Plains Farm,582,259,848,733,817,719,585,643,738,722,547,364,416,312,368,7812,8071,8653
E02001814,Grangetown,341,143,494,389,427,413,405,427,497,484,434,361,324,219,336,5210,5353,5694
E02001815,"Harraton, Rickleton & Fatfield",510,215,692,493,524,611,599,653,692,768,863,879,782,491,479,8526,8741,9251
E02001816,Lakeside & Farrington,303,136,450,470,448,430,357,415,527,567,522,459,422,290,435,5792,5928,6231
E02001817,Silksworth,322,157,501,416,545,447,406,384,475,466,481,404,321,288,387,5521,5678,6000
E02001818,Ryhope,503,240,702,633,709,675,663,604,670,685,606,493,370,266,405,7481,7721,8224
E02001819,Herrington & Doxford,250,124,455,376,391,412,419,393,523,610,549,526,563,416,540,6173,6297,6547
E02001820,Shiney Row,501,249,730,610,652,708,661,687,760,700,587,510,504,328,474,7911,8160,8661
E02001821,Hall Farm,259,132,383,369,369,353,346,341,513,520,494,358,340,190,261,4837,4969,5228
E02001822,Newbottle & Penshaw,348,161,607,473,511,481,443,552,675,636,550,464,421,276,386,6475,6636,6984
E02001823,Houghton West,402,195,600,605,614,610,530,474,640,587,522,427,405,257,319,6590,6785,7187
E02001824,Houghton Town,391,166,608,512,545,539,502,495,591,665,608,494,528,430,582,7099,7265,7656
E02001825,Hetton-le-Hole North,276,133,538,520,501,438,416,407,604,609,598,487,509,404,539,6570,6703,6979
E02001826,Hetton-le-Hole South,382,160,565,501,595,512,485,446,517,468,463,381,400,267,271,5871,6031,6413
E02001682,Ryton,378,156,588,434,579,602,557,557,696,631,547,488,518,361,519,7077,7233,7611
E02001683,Crawcrook & Greenside,388,162,580,539,605,583,589,578,713,777,717,568,611,440,539,7839,8001,8389
E02001684,"Pelaw, Felling Shore & Bill Quay",303,121,520,565,586,553,493,387,436,426,462,342,323,185,316,5594,5715,6018
E02001685,Blaydon South,407,196,635,582,619,618,554,492,569,576,479,376,373,286,385,6544,6740,7147
E02001686,Blaydon North & Winlaton Mill,251,125,422,384,358,404,393,425,534,595,489,443,409,360,514,5730,5855,6106
E02001688,Dunston & Teams,303,153,526,614,803,804,683,549,476,501,410,313,278,181,231,6369,6522,6825
E02001689,Bensham North,444,259,1546,926,705,669,500,522,501,493,404,352,313,204,361,7496,7755,8199
E02001690,Swalwell,320,128,494,462,475,468,440,486,562,592,471,440,421,279,408,5998,6126,6446
E02001691,Bensham South & Saltwell,417,304,1146,946,1064,853,698,623,532,490,405,325,245,166,215,7708,8012,8429
E02001692,Mount Pleasant & Deckham East,351,152,556,464,543,481,431,402,468,443,367,264,253,142,193,5007,5159,5510
E02001693,Felling South,231,127,392,353,361,387,312,364,426,476,380,323,308,198,313,4593,4720,4951
E02001694,Dunston Hill,272,112,461,377,414,445,403,393,503,501,458,370,345,245,342,5257,5369,5641
E02001695,Wardley,268,114,396,311,335,364,336,378,432,492,479,427,358,262,325,4895,5009,5277
E02001696,Heworth,472,233,739,594,665,659,621,579,657,664,623,520,499,295,500,7615,7848,8320
E02001697,Low Fell East,289,174,435,477,501,522,506,526,616,647,570,437,450,295,452,6434,6608,6897
E02001698,Whickham,278,117,374,290,303,372,413,438,472,467,498,516,660,509,753,6065,6182,6460
E02001699,Windy Nook & Whitehills,270,133,487,403,431,411,383,369,488,518,547,413,367,257,404,5478,5611,5881
E02001700,Sunniside & Lobley Hill,474,273,709,575,650,686,624,677,831,846,723,613,666,453,528,8581,8854,9328
E02001701,Low Fell West,258,107,380,316,366,407,402,373,459,520,463,380,457,339,502,5364,5471,5729
E02001702,Beacon Lough & Wrekenton,453,218,676,550,567,574,517,487,565,628,564,353,367,218,386,6452,6670,7123
E02001703,Rowlands Gill & Lockhaugh,231,114,362,271,296,280,317,333,445,481,406,375,417,322,436,4741,4855,5086
E02001704,Easedale Gardens,283,161,525,456,521,440,404,439,549,607,446,311,305,293,501,5797,5958,6241
E02001705,Chopwell & High Spen,306,150,466,381,430,459,432,429,496,541,525,485,455,296,361,5756,5906,6212
E02001706,Birtley North & Kibblesworth,380,158,488,441,573,588,555,485,537,501,439,411,384,276,359,6037,6195,6575
E02001707,Birtley South,380,190,593,502,502,550,508,514,657,647,556,499,486,407,578,6999,7189,7569
E02006841,Gateshead Town,205,336,1673,1362,1088,839,516,445,390,397,342,263,246,149,206,7916,8252,8457
E02006842,Gateshead South,323,182,495,459,422,393,396,331,339,293,284,230,214,168,275,4299,4481,4804
E02002574,Farnworth,374,205,558,457,555,658,639,611,670,689,565,443,526,372,426,7169,7374,7748
E02002575,Upton Rocks,520,255,765,484,520,620,614,727,852,858,738,548,520,326,354,7926,8181,8701
E02002576,Halton View,323,165,532,517,586,557,480,500,492,564,537,459,449,271,379,6323,6488,6811
E02002577,Hough Green,430,176,654,486,583,543,488,468,517,523,478,366,371,249,362,6088,6264,6694
E02002578,Victoria Park,477,218,663,542,631,636,618,539,656,612,550,452,376,263,349,6887,7105,7582
E02002579,Ditton,435,199,589,550,668,611,490,477,534,604,577,430,394,257,349,6530,6729,7164
E02002580,Widnes Riverside,450,170,736,748,826,715,591,493,541,559,456,345,286,188,286,6770,6940,7390
E02002581,Hale Bank,288,135,467,452,510,449,386,452,519,581,532,473,510,377,486,6194,6329,6617
E02002582,"Sandymoor, Daresbury & Preston Brook",477,266,886,640,634,690,672,736,884,818,674,540,519,244,261,8198,8464,8941
E02002583,Halton Castlefield,477,203,652,559,598,634,541,539,563,464,420,397,398,248,203,6216,6419,6896
E02002584,Runcorn Halton Road,374,209,590,483,529,533,470,502,535,552,481,413,402,263,345,6098,6307,6681
E02002585,Runcorn Town & Westfield,480,213,827,923,927,826,764,715,828,791,671,559,476,329,355,8991,9204,9684
E02002586,"Grange, Halton Brook & Hallwood Park",620,289,957,775,762,725,683,688,755,669,531,476,487,279,335,8122,8411,9031
E02002587,Norton,372,172,572,441,495,495,431,492,453,411,389,478,427,203,156,5443,5615,5987
E02002588,Halton Lea & Brookvale,384,196,614,557,516,529,504,563,481,443,459,478,502,241,267,6154,6350,6734
E02002589,Beechwood & Heath,264,121,376,286,334,376,381,450,445,448,449,569,617,356,376,5463,5584,5848
E02002590,Culcheth West & Croft,310,169,644,554,567,492,507,531,621,682,591,369,361,371,444,6734,6903,7213
E02002591,Culcheth East & Hollins Green,325,154,477,318,325,379,377,426,566,576,483,426,391,356,483,5583,5737,6062
E02002592,Winwick & Burtonwood,271,144,479,345,313,344,381,432,597,555,422,333,397,374,471,5443,5587,5858
E02002593,Locking Stumps,198,109,341,307,370,365,337,330,336,383,480,397,318,243,246,4453,4562,4760
E02002594,Oakwood & Gorse Covert,270,132,440,369,436,462,401,396,418,461,407,347,321,172,134,4764,4896,5166
E02002595,Hulme,460,228,714,650,761,757,575,524,560,620,488,331,222,152,233,6587,6815,7275
E02002596,Houghton Green & Fearnhead,335,162,579,458,539,562,489,524,615,626,633,647,623,398,377,7070,7232,7567
E02002597,Blackbrook,634,294,826,625,786,795,694,556,661,613,522,406,417,292,280,7473,7767,8401
E02002598,Kingswood & Whittle Hall,692,273,813,745,877,992,971,920,922,772,581,433,354,173,203,8756,9029,9721
E02002599,Callands & Old Hall,621,308,899,672,707,727,904,883,923,981,802,628,541,366,389,9422,9730,10351
E02002600,Orford,466,183,819,780,869,787,649,581,788,728,574,430,366,301,437,8109,8292,8758
E02002601,Padgate & Paddington,413,188,627,521,623,732,644,645,727,699,623,448,510,450,531,7780,7968,8381
E02002602,Bewsey & Dallam,480,206,763,814,938,888,720,650,591,535,399,261,237,149,142,7087,7293,7773
E02002603,Woolston,331,168,499,374,412,390,475,514,611,571,496,476,567,375,348,6108,6276,6607
E02002604,Great Sankey,333,184,543,445,405,462,494,556,611,623,513,475,501,430,491,6549,6733,7066
E02002605,Hood Manor & Sankey Bridges,484,250,723,529,671,627,658,643,713,684,511,529,523,308,359,7478,7728,8212
E02002606,Fairfield & Howley,484,218,917,1071,1318,1218,997,861,853,748,546,357,365,251,409,9911,10129,10613
E02002607,Central Warrington,445,189,843,1105,1217,1230,908,821,807,817,607,479,512,401,542,10289,10478,10923
E02002608,Penketh & Cuerdley,320,185,499,411,455,453,421,526,662,640,512,454,577,572,846,7028,7213,7533
E02002609,Latchford,506,204,755,730,944,882,769,669,648,644,445,358,329,200,335,7708,7912,8418
E02002610,Lymm,797,355,844,517,532,774,958,1037,1105,1075,766,687,712,640,809,10456,10811,11608
E02002611,Grappenhall,389,199,520,332,425,452,547,563,663,667,570,411,425,371,627,6573,6772,7161
E02002612,Stockton Heath & Hillcliffe,453,229,688,450,448,569,674,713,823,779,617,495,518,432,618,7824,8053,8506
E02002613,"Appleton Thorn, Stretton & Walton",345,164,513,474,462,476,511,537,607,694,546,395,388,324,325,6252,6416,6761
E02002614,Appleton,306,168,409,265,208,244,324,370,557,632,498,429,461,364,437,5198,5366,5672
E02002615,"Roe Lee, Brownhill & Sunnybower",655,293,880,718,837,869,805,671,630,669,519,423,470,359,567,8417,8710,9365
E02002616,Lammack & Revidge,648,314,913,612,716,861,780,619,540,489,434,372,335,252,349,7272,7586,8234
E02002617,Little Harwood,801,369,1193,785,796,838,858,689,623,466,449,358,237,144,184,7620,7989,8790
E02002618,Bastwell,644,276,960,641,624,693,683,646,476,328,339,345,215,108,183,6241,6517,7161
E02002619,Wensley Fold,720,296,1015,794,891,937,847,688,629,470,432,359,269,182,280,7793,8089,8809
E02002620,Central Blackburn,616,268,970,755,817,815,809,727,617,450,442,446,275,158,232,7513,7781,8397
E02002621,Audley,714,331,1108,728,686,736,741,659,573,414,393,333,239,120,155,6885,7216,7930
E02002622,Shadsworth & Intack,843,407,1190,844,949,1011,832,708,720,631,497,408,319,195,247,8551,8958,9801
E02002623,"Witton, Mill Hill & Hollin Bank",632,306,1010,905,1021,969,815,783,765,690,539,404,391,231,306,8829,9135,9767
E02002624,"Beardwood, Pleasington & Livesey",400,218,617,533,552,497,473,558,713,666,610,529,545,434,581,7308,7526,7926
E02002625,Queen's Park & Higher Croft,667,320,937,775,877,828,678,711,818,673,571,403,375,224,264,8134,8454,9121
E02002626,Meadowhead,431,186,629,511,501,516,489,448,552,572,464,424,413,267,391,6177,6363,6794
E02002627,Ewood & Fernhurst,471,210,643,438,481,551,521,637,705,596,443,309,289,204,182,5999,6209,6680
E02002628,North Darwen,326,149,547,520,548,550,429,427,558,527,458,372,372,252,316,5876,6025,6351
E02002629,East Darwen,320,161,577,457,509,475,388,375,407,405,334,306,234,157,199,4823,4984,5304
E02002630,Darwen Town,306,157,568,465,496,479,392,462,460,470,407,279,281,173,311,5243,5400,5706
E02002631,South Darwen & Whitehall,393,207,663,628,607,589,520,621,781,783,610,507,586,368,373,7636,7843,8236
E02002632,"Tockholes, Edgworth & Hoddlesden",286,134,400,266,340,353,331,399,599,666,510,478,441,336,279,5398,5532,5818
E02002633,Little Bispham & Anchorsholme,328,162,508,378,454,440,394,469,584,603,533,486,605,544,694,6692,6854,7182
E02002634,Churchtown,304,191,546,457,498,427,418,518,634,740,633,523,615,494,652,7155,7346,7650
E02002635,Norbreck & Bispham,293,165,530,427,441,442,396,465,583,683,572,547,573,500,662,6821,6986,7279
E02002636,Warbreck & Bispham Road,375,176,581,528,655,529,459,539,651,631,598,478,435,329,370,6783,6959,7334
E02002637,Hoohill,265,138,413,368,451,424,373,422,541,494,462,332,340,300,366,5286,5424,5689
E02002638,North Shore,319,183,613,493,591,559,547,550,613,627,505,366,325,193,272,6254,6437,6756
E02002639,Little Layton & Little Carleton,401,187,601,421,465,461,415,460,485,420,352,294,243,143,164,4924,5111,5512
E02002640,North East Centre,436,187,683,569,657,592,540,438,566,565,435,327,252,162,203,5989,6176,6612
E02002641,Queenstown & Layton,344,210,620,622,687,600,511,523,619,697,528,407,396,288,402,6900,7110,7454
E02002642,Central Blackpool,400,176,709,657,776,726,607,547,654,693,560,388,301,222,285,7125,7301,7701
E02002643,Park Road,426,270,779,636,721,662,537,502,587,635,492,361,317,195,244,6668,6938,7364
E02002644,Stanley Park & Great Marton,349,168,554,477,582,523,433,501,651,654,539,443,418,316,439,6530,6698,7047
E02002645,South Promenade & Seasiders Way,339,169,639,523,619,579,464,535,558,617,518,383,279,189,171,6074,6243,6582
E02002646,Little Marton & Marton Moss Side,311,185,518,468,483,458,436,441,539,608,471,446,479,318,404,6069,6254,6565
E02002647,Victoria,444,187,677,619,723,614,539,566,607,646,516,396,387,254,330,6874,7061,7505
E02002648,Hawes Side,390,155,551,499,526,508,440,431,529,522,449,367,380,274,310,5786,5941,6331
E02002649,South Shore,377,196,662,541,660,561,520,536,686,762,574,463,488,377,532,7362,7558,7935
E02002650,Common Edge,311,149,558,504,549,514,439,472,672,676,636,574,596,460,614,7264,7413,7724
E02002651,Squires Gate,344,189,528,452,509,501,437,450,636,627,587,498,495,466,611,6797,6986,7330
E02003811,Cranage & Goostrey,354,181,473,314,375,409,413,460,631,671,537,503,510,418,444,6158,6339,6693
E02003812,Holmes Chapel,318,157,376,286,296,398,463,468,485,477,416,355,508,401,539,5468,5625,5943
E02003813,Middlewich West,213,103,402,307,328,320,325,357,542,548,477,450,423,330,426,5235,5338,5551
E02003814,Middlewich East,444,222,632,543,662,597,545,549,724,694,537,410,387,239,252,6771,6993,7437
E02003815,Buglawton,402,179,530,448,581,504,471,516,548,518,446,379,374,285,368,5968,6147,6549
E02003816,Congleton Town,319,135,472,489,517,464,496,495,594,566,473,416,484,399,433,6298,6433,6752
E02003817,Congleton West Heath,349,163,430,353,416,424,490,496,598,562,527,494,616,424,565,6395,6558,6907
E02003818,"Hightown, Mossley & Timbersbrook",221,106,336,254,294,293,322,370,457,504,413,453,492,381,453,5022,5128,5349
E02003819,Sandbach North,297,154,415,358,416,417,401,437,466,493,474,440,520,454,518,5809,5963,6260
E02003820,Sandbach Ettiley Heath & Wheelock,488,247,661,641,830,731,657,737,781,745,552,376,379,288,314,7692,7939,8427
E02003821,Sandbach Heath,234,118,352,355,400,353,295,379,488,477,405,403,383,345,422,5057,5175,5409
E02003822,"Scholar Green, Rode Heath & Brereton",478,211,681,643,685,599,622,727,961,1059,899,798,881,657,720,9932,10143,10621
E02003823,Alsager East,291,151,420,345,398,447,395,429,496,510,445,408,527,457,625,5902,6053,6344
E02003824,Alsager West,353,155,417,345,440,436,420,460,460,471,384,347,406,329,367,5282,5437,5790
E02003825,Crewe Leighton,308,143,508,427,431,400,416,478,562,629,461,318,266,155,123,5174,5317,5625
E02003826,Crewe North East,498,228,738,751,770,731,584,532,546,516,515,382,346,244,292,6947,7175,7673
E02003827,Crewe Coppenhall & Underwood,529,221,818,891,1013,893,679,658,649,598,499,392,363,303,375,8131,8352,8881
E02003828,Crewe North West,427,163,563,501,595,581,459,464,419,435,376,260,301,207,251,5412,5575,6002
E02003829,Crewe Sydney & Gateway,169,100,426,461,450,343,329,332,427,460,366,353,412,358,392,5109,5209,5378
E02003830,Crewe Town & Victoria Avenue,426,195,763,789,787,771,605,597,590,507,453,344,254,186,284,6930,7125,7551
E02003831,Haslington & Weston,437,207,659,527,570,566,596,673,866,874,777,619,652,514,580,8473,8680,9117
E02003832,Crewe Mill Street & College,307,164,612,714,825,764,637,527,516,437,292,244,194,119,161,6042,6206,6513
E02003833,Wistaston Green,333,166,483,456,478,445,404,439,502,515,390,326,306,257,299,5300,5466,5799
E02003834,Crewe Gresty Road,346,163,681,662,677,651,574,524,516,473,392,250,228,153,234,6015,6178,6524
E02003835,Crewe South West & Wistaston,331,161,512,417,434,428,462,553,649,723,624,592,619,536,745,7294,7455,7786
E02003836,Nantwich North East,241,126,415,388,393,442,377,397,526,476,451,465,543,399,719,5991,6117,6358
E02003837,Nantwich South East & Wybunbury,845,468,1170,897,926,943,992,1181,1386,1316,1052,770,791,567,557,12548,13016,13861
E02003838,Willaston & Shavington,354,172,482,552,603,580,471,529,623,578,497,443,525,388,433,6704,6876,7230
E02003839,Nantwich South West,280,140,438,373,403,405,428,450,529,534,443,432,529,450,644,6058,6198,6478
E02003840,"Audlem, Bunbury & Wrenbury",486,255,618,480,456,516,602,715,953,1018,1074,905,849,654,833,9673,9928,10414
E02003853,Disley & Lyme Park,252,131,344,291,388,386,382,392,520,580,474,417,455,333,416,5378,5509,5761
E02003854,Poynton West,300,159,428,294,341,431,467,417,490,501,430,428,497,384,451,5559,5718,6018
E02003855,Poynton East,305,126,362,251,310,373,370,437,455,471,484,464,570,494,678,5719,5845,6150
E02003856,Handforth & Dean Row,565,251,738,758,898,963,863,745,881,904,692,546,576,433,612,9609,9860,10425
E02003857,Lacey Green & Wilmslow Park,410,165,436,444,499,573,545,546,595,504,443,345,418,213,273,5834,5999,6409
E02003858,Wilmslow Town,371,198,527,405,448,507,559,577,604,589,513,417,456,341,596,6539,6737,7108
E02003859,"Mobberley, Plumley & High Legh",534,225,734,566,678,804,795,874,913,1047,925,786,894,658,924,10598,10823,11357
E02003860,Fulshaw Park & Lindow,430,183,452,281,388,502,656,612,607,587,432,355,446,320,492,6130,6313,6743
E02003861,Knutsford North,326,160,425,378,404,438,452,485,484,451,366,333,351,315,467,5349,5509,5835
E02003862,Prestbury & Adlington,249,126,347,215,227,197,258,347,439,533,420,421,420,399,544,4767,4893,5142
E02003863,South Knutsford & Bexton,361,171,391,281,328,396,492,530,529,532,462,402,434,362,568,5707,5878,6239
E02003864,Alderley Edge & Chelford,356,198,562,405,529,535,590,619,721,750,667,551,624,454,737,7744,7942,8298
E02003865,Bollington,411,172,456,367,502,534,578,589,723,748,564,521,532,388,462,6964,7136,7547
E02003866,Macclesfield Tytherington,322,150,427,314,307,345,415,449,527,570,484,393,419,314,385,5349,5499,5821
E02003867,Macclesfield Upton Priory & Greenside,401,213,523,389,501,505,486,538,597,628,529,433,415,300,406,6250,6463,6864
E02003868,Macclesfield East & Hurdsfield,396,166,596,520,625,647,602,615,652,621,512,468,471,310,464,7103,7269,7665
E02003869,Macclesfield Bollinbrook,345,152,458,388,531,500,459,521,554,578,525,413,447,403,541,6318,6470,6815
E02003870,Central Macclesfield,379,165,724,886,1049,986,775,758,855,807,616,484,458,302,461,9161,9326,9705
E02003871,Macclesfield Weston,308,149,494,411,441,506,445,439,548,554,463,403,426,306,371,5807,5956,6264
E02003872,Gawsworth & Macclesfield Forest,412,207,617,389,479,495,503,614,849,988,926,744,776,639,792,8811,9018,9430
E02003873,Macclesfield South & Lyme Green,306,137,408,483,504,449,400,389,483,505,387,290,283,182,244,5007,5144,5450
E02003794,"Elton, Mickle Trafford & Great Barrow",445,213,555,455,481,581,578,551,731,738,668,560,604,436,430,7368,7581,8026
E02003795,"Capenhurst, Saughall & Moston",286,120,601,425,439,446,399,382,417,454,378,397,434,300,462,5534,5654,5940
E02003796,Upton East,346,149,485,407,489,552,527,452,506,550,528,455,422,360,630,6363,6512,6858
E02003797,Upton West & Heath,448,233,798,643,705,714,744,750,820,748,592,500,545,372,652,8583,8816,9264
E02003798,Blacon North,389,169,505,432,518,542,417,432,419,500,387,297,291,214,241,5195,5364,5753
E02003799,Blacon South,408,166,553,521,580,543,492,461,524,561,470,366,338,259,370,6038,6204,6612
E02003800,"Kelsall, Tarvin & Ashton Hayes",351,157,409,301,356,393,421,483,595,547,499,435,514,446,532,5931,6088,6439
E02003801,Vicars Cross & Hoole East,365,176,455,353,491,556,557,548,519,531,488,404,396,279,446,6023,6199,6564
E02003802,Chester Boughton West & Hoole,192,93,978,1158,1055,826,660,577,534,547,573,435,378,285,410,8416,8509,8701
E02003803,Chester City & Garden Quarter,154,97,2760,1425,1043,757,562,452,484,496,429,331,340,233,381,9693,9790,9944
E02003804,Chester Boughton East,286,142,441,580,612,621,520,509,468,512,424,344,341,234,372,5978,6120,6406
E02003805,"Christleton, Guilden Sutton & Waverton",330,176,441,282,293,369,347,467,523,511,452,420,453,380,504,5442,5618,5948
E02003806,Boughton Heath & Huntington,424,192,440,422,576,667,588,632,570,539,465,442,403,318,517,6579,6771,7195
E02003807,Chester Handbridge Park,357,211,488,438,460,540,597,637,699,709,592,505,638,558,644,7505,7716,8073
E02003808,Lache,340,149,519,461,564,536,439,464,525,500,401,311,281,170,192,5363,5512,5852
E02003809,"Dodleston, Tattenhall & Duddon",408,200,509,370,403,454,456,572,700,745,570,546,564,454,633,6976,7176,7584
E02003810,"Churton, Farndon & Malpas",496,238,597,483,528,571,598,687,795,787,686,640,698,501,632,8203,8441,8937
E02003841,Neston & Parkgate,349,181,546,400,429,413,416,499,613,633,560,573,626,489,650,6847,7028,7377
E02003842,"Hooton, Willaston & Ness",224,114,304,250,262,298,288,334,448,551,489,440,496,400,497,5057,5171,5395
E02003843,Little Sutton North & Overpool,280,126,462,368,481,424,387,392,485,534,486,407,361,243,411,5441,5567,5847
E02003844,Little Neston,264,123,448,320,346,385,373,412,483,502,524,498,549,418,499,5757,5880,6144
E02003845,Ellesmere Port Town & Rossmore,531,217,920,1096,1114,921,754,687,718,698,517,385,316,216,333,8675,8892,9423
E02003846,Little Sutton East,426,171,577,535,598,538,450,432,504,493,407,298,250,186,311,5579,5750,6176
E02003847,Little Sutton West,437,231,727,580,675,604,627,636,829,940,786,621,587,407,469,8488,8719,9156
E02003848,Ellesmere Port Pooltown Road,310,128,456,342,427,376,344,346,396,391,376,231,233,177,284,4379,4507,4817
E02003849,Wolverham & Stanlow,406,206,727,629,726,683,547,484,634,540,402,317,301,232,244,6466,6672,7078
E02003850,Great Sutton,216,102,388,317,336,351,318,289,398,410,378,329,346,234,300,4394,4496,4712
E02003851,Whitby & Stanney Woods,231,129,420,340,353,353,355,389,498,534,432,342,393,256,355,5020,5149,5380
E02003852,Ellesmere Port South,285,133,437,381,392,419,401,410,477,531,553,472,437,325,465,5700,5833,6118
E02003874,Frodsham,425,209,565,440,504,547,652,633,752,779,611,586,669,509,703,7950,8159,8584
E02003875,"Comberbach, Acton Bridge & Whitley",252,123,330,241,260,269,349,433,528,655,615,494,549,415,434,5572,5695,5947
E02003876,Barnton,279,136,376,333,435,381,366,360,403,416,357,350,408,254,231,4670,4806,5085
E02003877,Helsby & Kingsley,388,213,609,513,518,505,556,652,814,840,790,649,723,568,721,8458,8671,9059
E02003878,Lostock & Wincham,393,173,533,451,528,586,565,607,742,765,683,633,624,441,575,7733,7906,8299
E02003879,Northwich Central & Winnington,393,178,562,769,965,865,685,636,595,533,455,318,284,214,352,7233,7411,7804
E02003880,Weaverham,327,182,434,326,394,400,368,400,511,501,431,412,437,332,386,5332,5514,5841
E02003881,Greenbank,307,128,405,430,418,449,404,456,478,499,407,352,317,190,179,4984,5112,5419
E02003882,Rudheath West & Leftwich,523,224,709,648,766,724,625,656,777,742,623,541,468,324,404,8007,8231,8754
E02003883,Hartford & Kingsmead,618,335,750,479,523,628,781,912,1026,969,781,594,626,442,566,9077,9412,10030
E02003884,Sandiway,424,212,476,348,414,466,534,561,677,768,618,601,657,532,675,7327,7539,7963
E02003885,Davenham & Moulton,303,135,375,323,326,404,376,438,509,531,458,393,440,324,373,5270,5405,5708
E02003886,Wharton,320,148,532,485,624,502,381,483,571,524,349,296,279,203,273,5502,5650,5970
E02003887,Winsford North,325,142,530,485,506,483,399,474,562,537,439,371,359,255,234,5634,5776,6101
E02003888,Winsford Central,298,148,522,513,526,456,402,453,505,518,450,296,285,228,323,5477,5625,5923
E02003889,Winsford Over,393,176,500,466,501,499,394,361,427,423,315,269,259,249,271,4934,5110,5503
E02003890,Winsford Glebe Green,310,175,530,538,551,538,430,420,533,548,441,363,340,265,236,5733,5908,6218
E02003891,Tarporley & Eddisbury Hill,339,167,357,247,268,297,370,475,526,576,507,469,522,400,471,5485,5652,5991
E02003965,Wigton & Silloth,467,227,828,633,620,495,551,675,895,931,847,796,851,606,856,9584,9811,10278
E02003966,"Boltons, Warnell & Solway Coast",296,131,449,321,307,322,350,424,639,690,632,582,629,383,480,6208,6339,6635
E02003967,Aspatria & Abbeytown,382,146,510,445,467,427,405,502,630,725,669,568,604,405,490,6847,6993,7375
E02003968,"Maryport, Dearham & Crosby",386,208,621,485,507,521,500,595,735,719,593,564,635,452,522,7449,7657,8043
E02003969,"Flimby, Ellenborough & Broughton Moor",357,120,523,460,477,413,388,409,461,497,425,331,383,259,343,5369,5489,5846
E02003970,West Cockermouth & Great Broughton,365,158,484,408,438,455,470,506,695,716,658,585,597,385,545,6942,7100,7465
E02003971,East Cockermouth & Buttermere,340,187,461,341,355,413,430,505,668,685,659,586,659,444,590,6796,6983,7323
E02003972,Workington North & Seaton,398,194,620,532,577,562,486,571,727,765,607,499,571,360,545,7422,7616,8014
E02003973,Workington West,402,177,678,636,660,624,533,543,619,649,556,494,450,283,367,7092,7269,7671
E02003974,Workington East,392,153,523,503,501,504,432,398,518,557,561,424,481,351,429,6182,6335,6727
E02003975,"Harrington, Stainburn & Great Clifton",318,164,441,358,451,436,417,464,572,527,513,459,482,357,496,5973,6137,6455
E02003976,Keswick & Derwent Valley,301,147,398,364,368,323,389,403,554,549,573,440,473,374,590,5798,5945,6246
E02003977,Askam & Dalton North,259,134,512,398,385,330,338,368,502,544,449,367,386,272,317,5168,5302,5561
E02003978,Dalton South,248,129,479,369,345,291,322,353,443,491,441,354,327,273,390,4878,5007,5255
E02003979,Hawcoat & Furness Abbey,287,148,470,382,416,371,389,456,604,628,591,539,642,523,748,6759,6907,7194
E02003980,Orsmgill & Hindpool,332,132,542,515,553,426,376,406,500,495,429,368,341,226,242,5419,5551,5883
E02003981,Parkside,281,175,556,472,483,475,397,404,533,532,449,325,326,256,320,5528,5703,5984
E02003982,Roose,438,192,543,471,530,521,439,518,644,620,542,460,499,418,417,6622,6814,7252
E02003983,Abbotsmead & Salthouse,384,190,612,578,581,518,431,460,596,567,469,375,356,241,268,6052,6242,6626
E02003984,Barrow Central,295,152,612,597,612,501,384,394,449,458,378,319,298,191,244,5437,5589,5884
E02003985,Walney Island North,290,145,469,424,417,372,336,439,503,508,459,403,487,355,386,5558,5703,5993
E02003986,Walney Island South & Barrow Island,256,116,437,406,426,429,360,398,472,503,414,367,396,311,308,5227,5343,5599
E02003987,Longtown & Border,272,141,376,277,338,351,298,345,498,540,524,429,420,292,367,5055,5196,5468
E02003988,Brampton & Irthing,277,167,426,291,317,319,335,387,532,628,543,537,486,352,496,5649,5816,6093
E02003989,Carlisle Belah,325,163,467,368,417,465,492,481,502,543,576,497,509,404,573,6294,6457,6782
E02003990,"Kingmoor, Houghton & Whiteclosegate",509,237,665,552,638,711,706,704,790,835,787,652,694,483,734,8951,9188,9697
E02003991,Belle Vue & Burgh,307,151,435,347,413,388,423,470,533,637,627,575,560,467,525,6400,6551,6858
E02003992,Central Carlisle,293,136,789,770,631,645,575,549,614,626,552,395,406,250,357,7159,7295,7588
E02003993,"Wetheral, Corby & Geltsdale",360,178,521,362,351,473,467,509,684,828,868,722,763,496,620,7664,7842,8202
E02003994,Longsowerby & Caldewgate,299,143,536,568,619,535,460,463,514,534,475,342,341,242,443,6072,6215,6514
E02003995,Raffles & Morton,483,207,700,735,818,733,587,707,678,717,620,471,498,357,536,8157,8364,8847
E02003996,Denton Holme & Harraby Green,340,183,765,877,871,736,612,632,701,724,632,420,373,215,295,7853,8036,8376
E02003997,Botcherby & Harraby,603,247,804,709,799,792,666,623,685,599,501,458,413,293,358,7700,7947,8550
E02003998,Currock & Upperby,354,166,465,412,450,458,404,382,461,436,384,334,307,234,313,5040,5206,5560
E02003999,Garlands & Dalston,569,280,681,668,799,735,658,767,865,867,815,747,765,595,737,9699,9979,10548
E02004000,Parton & Distington,245,98,348,251,364,333,263,327,401,422,374,333,362,223,313,4314,4412,4657
E02004001,Whitehaven Harbour & Corkickle,186,101,387,352,342,355,317,308,437,483,401,307,330,238,317,4574,4675,4861
E02004002,"Hensingham, Hillcrest & Aikbank",446,213,698,600,547,538,526,663,808,834,687,606,604,439,571,8121,8334,8780
E02004003,"Cleator Moor, Frizington & Ennerdale",460,257,803,733,749,715,612,688,898,1083,976,746,713,497,573,9786,10043,10503
E02004004,"Mirehouse, Kells & Woodhouse",521,208,691,720,803,711,590,595,655,711,636,562,523,304,471,7972,8180,8701
E02004005,Egremont & Moor Row,359,175,587,430,459,500,420,492,563,609,582,506,459,351,419,6377,6552,6911
E02004006,"Thornhill, Gosforth & Seascale",333,160,433,356,401,446,444,532,670,818,755,681,635,465,614,7250,7410,7743
E02004007,Millom & Duddon Valley,395,184,604,548,596,524,505,572,753,881,819,692,724,513,611,8342,8526,8921
E02004008,"Langwathby, Kirkoswald & Alston Moor",263,114,347,285,296,292,351,386,523,612,618,536,543,322,340,5451,5565,5828
E02004009,"Hesket, Lazonby & Skelton",243,133,361,267,334,300,299,341,500,627,533,481,438,318,360,5159,5292,5535
E02004010,Penrith Central & West,332,145,508,532,574,546,500,493,559,505,488,334,397,289,492,6217,6362,6694
E02004011,Penrith Outer,467,231,702,622,648,586,569,675,873,879,791,727,780,601,854,9307,9538,10005
E02004012,"Askham, Ullswater & Greystoke",216,100,329,236,258,273,290,352,435,539,529,396,436,304,382,4759,4859,5075
E02004013,"Appleby, Shap & Kirkby Thore",424,215,635,472,497,491,497,591,765,885,842,733,781,550,683,8422,8637,9061
E02004014,"Kirkby Stephen, Tebay & Brough",300,154,461,340,327,371,376,427,634,717,657,595,607,462,546,6520,6674,6974
E02004015,"Windermere North, Ambleside & Langdales",232,129,661,509,490,487,398,367,494,529,456,434,396,364,536,6121,6250,6482
E02004016,Windermere South & Staveley,301,178,576,578,590,572,580,522,683,726,618,524,518,431,508,7426,7604,7905
E02004017,Kendal North & Burneside,392,180,613,538,609,584,621,577,691,760,596,529,564,372,563,7617,7797,8189
E02004018,Kendal Town & Greenside,417,180,635,589,622,590,572,586,647,627,597,456,449,302,387,7059,7239,7656
E02004019,Kendal East & Whinfell,306,169,510,361,392,376,405,486,649,672,617,568,640,476,625,6777,6946,7252
E02004020,Kendal South,396,191,542,506,573,532,529,592,682,691,626,523,603,454,643,7496,7687,8083
E02004021,Hawkshead & Cartmel Fell,170,72,291,243,218,246,282,320,435,528,527,398,488,361,367,4704,4776,4946
E02004022,"Coniston, Broughton & Kirkby",213,108,296,243,300,295,282,318,436,537,517,457,474,325,348,4828,4936,5149
E02004023,Sedbergh & Kirkby Lonsdale,589,377,409,269,253,269,270,359,451,538,538,449,501,375,535,5216,5593,6182
E02004024,"Burton-in-Kendal, Levens & Natland",358,193,468,309,319,349,397,450,604,678,646,553,628,495,656,6552,6745,7103
E02004025,"Arnside, Milnthorpe & Holme",352,177,439,288,343,373,425,476,560,671,643,615,720,562,730,6845,7022,7374
E02004026,Ulverston,337,173,590,481,568,492,481,555,716,672,559,446,519,358,465,6902,7075,7412
E02004027,Grange-over-Sands & Cartmel Peninsula,235,132,408,370,367,350,318,391,562,685,697,725,771,648,965,7257,7389,7624
E02004028,Swarthmoor & Low Furness,305,163,435,385,357,412,362,446,597,679,643,578,669,511,641,6715,6878,7183
E02005176,Harle Syke & Lanehead,487,219,697,590,659,622,570,595,630,633,602,482,522,416,387,7405,7624,8111
E02005177,Queensgate,379,161,528,462,514,531,465,437,409,379,339,297,319,193,357,5230,5391,5770
E02005178,Central Burnley & Daneshouse,905,439,1301,1010,1118,1073,942,823,689,485,429,331,223,162,203,8789,9228,10133
E02005179,Padiham,496,224,714,588,709,635,548,559,724,704,630,495,445,334,410,7495,7719,8215
E02005180,Habergham & Ightenhill,329,172,487,395,437,445,400,437,543,566,515,470,508,316,424,5943,6115,6444
E02005181,Whittlefield & Rose Grove,331,154,504,536,520,479,413,449,442,437,407,336,337,231,258,5349,5503,5834
E02005182,Bank Hall & Fulledge,367,163,524,480,537,520,442,398,444,399,364,287,285,221,268,5169,5332,5699
E02005183,Brunshaw & Brownside,305,144,421,343,367,416,333,383,476,493,439,370,372,305,331,5049,5193,5498
E02005184,"Cliviger, Worsthorne & Lane Bottom",187,83,318,245,265,264,265,310,416,469,426,399,453,330,296,4456,4539,4726
E02005185,Barclay Hills & Trinity,512,252,828,801,881,741,605,629,637,642,529,401,365,238,253,7550,7802,8314
E02005186,Hapton & Lowerhouse,291,148,440,365,445,388,427,390,538,544,446,350,385,223,250,5191,5339,5630
E02006881,Rose Hill & Burnley Wood,536,238,794,726,780,764,665,653,744,765,697,594,583,403,482,8650,8888,9424
E02005189,Clayton Brook,304,119,394,355,427,409,360,360,361,399,386,288,278,211,281,4509,4628,4932
E02005190,Brindle & Withnell,280,126,393,274,321,325,340,448,586,568,540,399,463,323,349,5329,5455,5735
E02005191,Clayton-le-Woods,447,241,595,508,601,672,645,605,758,786,628,614,618,404,420,7854,8095,8542
E02005192,Whittle-le-Woods & Anglezarke,417,242,612,470,611,630,639,687,782,672,613,439,404,269,300,7128,7370,7787
E02005193,Euxton,420,221,541,412,526,530,533,614,684,663,594,555,664,481,467,7264,7485,7905
E02005194,Chorley North,365,184,589,530,624,519,509,491,626,632,505,490,454,374,452,6795,6979,7344
E02005195,Croston & Mawdesley,348,161,546,529,601,614,581,606,679,672,562,468,489,342,394,7083,7244,7592
E02005196,Chorley West,516,226,660,648,738,934,831,724,683,628,549,582,660,471,600,8708,8934,9450
E02005197,Chorley East,365,157,552,520,568,540,501,488,560,530,443,343,330,243,269,5887,6044,6409
E02005198,Chorley Town & South,482,186,693,654,753,723,685,693,692,732,550,414,486,376,428,7879,8065,8547
E02005199,Eccleston & Charnock Richard,337,162,493,343,392,450,456,509,657,658,529,503,601,472,485,6548,6710,7047
E02005200,Chorley South West,525,246,673,637,683,643,611,653,778,674,483,368,360,224,274,7061,7307,7832
E02005201,Coppull,409,168,615,477,596,569,472,574,649,583,522,468,469,358,432,6784,6952,7361
E02005202,Adlington & Rivington,424,219,623,501,636,604,636,691,817,818,708,607,664,518,596,8419,8638,9062
E02005203,"Elswick, Singleton & Weeton",363,168,773,689,700,632,514,497,715,767,677,632,625,487,473,8181,8349,8712
E02005204,Kirkham & Wesham,565,347,886,744,889,876,794,797,929,950,888,704,759,538,595,10349,10696,11261
E02005205,Clifton & Newton-with-Scales,283,148,459,405,451,503,417,409,510,530,486,414,434,351,324,5693,5841,6124
E02005206,St Annes North & Airport,332,152,419,358,468,486,388,400,540,587,570,546,507,371,495,6135,6287,6619
E02005207,Heyhouses & Park,398,182,471,331,386,404,440,525,600,671,749,677,749,588,789,7380,7562,7960
E02005208,St Annes Town,355,184,591,494,609,583,594,623,785,968,864,694,743,622,1055,9225,9409,9764
E02005209,Warton & Freckleton,336,183,533,490,541,556,462,449,659,761,687,657,632,515,566,7508,7691,8027
E02005210,Ansdell & Fairhaven,396,189,548,364,328,441,496,574,800,886,859,796,888,752,1219,8951,9140,9536
E02005211,Lytham,313,184,482,310,400,418,465,576,683,800,779,605,675,647,822,7662,7846,8159
E02005212,Great Harwood,530,266,851,730,760,708,666,765,776,797,708,616,633,488,597,9095,9361,9891
E02005213,Clayton-le-Moors & Huncoat,596,286,892,688,838,754,727,782,979,857,697,656,667,406,476,9419,9705,10301
E02005214,Rishton,321,156,556,513,436,410,387,413,538,529,432,355,378,289,309,5545,5701,6022
E02005215,Accrington North East,613,330,1006,891,952,818,836,769,916,886,790,617,621,455,564,10121,10451,11064
E02005216,Church,305,137,465,383,394,413,353,345,416,396,329,259,278,201,203,4435,4572,4877
E02005217,Accrington West,1042,499,1482,1044,1191,1241,954,854,777,574,487,417,338,241,336,9936,10435,11477
E02005218,Oswaldtwistle,349,183,539,521,562,544,427,473,558,579,480,345,401,307,414,6150,6333,6682
E02005219,Accrington South East,358,194,642,632,614,538,518,575,730,635,584,500,499,354,395,7216,7410,7768
E02005220,Broadfield & Knuzden,254,126,380,322,357,308,334,380,489,533,438,417,446,342,369,5115,5241,5495
E02005221,"Carnforth, Silverdale & Warton",464,198,601,491,508,517,506,621,777,857,832,768,794,582,754,8608,8806,9270
E02005222,Kellet & Lune Valley,251,140,520,273,299,304,308,346,492,609,573,492,526,407,475,5624,5764,6015
E02005223,Hest Bank & Bolton-le-Sands,289,131,457,296,336,363,351,454,552,628,626,572,655,492,644,6426,6557,6846
E02005224,Bare,166,81,293,179,189,216,227,272,338,432,395,389,480,461,785,4656,4737,4903
E02005225,Halton & Caton,276,124,336,312,298,387,379,377,472,478,430,402,424,306,411,5012,5136,5412
E02005226,Morecambe Town,417,190,682,516,617,586,504,500,550,593,512,419,378,286,393,6536,6726,7143
E02005228,Morecambe South West,300,137,464,332,418,423,406,362,416,415,447,321,322,191,277,4794,4931,5231
E02005229,Morecambe West End,299,148,545,494,476,476,443,412,458,484,370,277,237,157,179,5008,5156,5455
E02005230,Morecambe Westgate,341,147,521,415,444,415,457,371,491,499,503,442,483,389,430,5860,6007,6348
E02005231,Skerton & Vale,401,167,762,653,654,693,577,527,580,631,511,406,370,204,265,6833,7000,7401
E02005233,Lancaster East,405,190,743,689,739,788,763,587,576,535,440,353,292,199,208,6912,7102,7507
E02005234,Lancaster Central,302,154,2591,1314,769,661,483,445,417,395,328,252,230,142,216,8243,8397,8699
E02005235,Moorlands & Greaves,134,59,1240,615,488,381,343,290,281,245,190,133,131,91,119,4547,4606,4740
E02005236,Heysham & Overton,683,325,959,765,922,894,845,836,1022,1090,938,811,863,700,749,11394,11719,12402
E02005237,"Marsh, Haverbreaks & Scotforth West",539,299,1140,825,864,780,665,630,787,744,648,502,483,323,469,8860,9159,9698
E02005238,Scotforth East & Bowerham,263,120,570,423,427,493,398,354,370,376,349,315,284,186,339,4884,5004,5267
E02005239,"University, Galgate & Dolphinholme",337,203,9080,2668,990,740,569,501,568,552,532,419,445,318,419,17801,18004,18341
E02006871,Scale Hall & Torrisholme,551,278,896,748,849,748,662,729,932,929,831,739,707,583,745,10098,10376,10927
E02005240,Barnoldswick North,261,127,401,360,420,443,340,359,453,408,321,294,327,234,318,4678,4805,5066
E02005241,Barnoldswick South,202,116,375,364,410,369,324,389,426,462,387,368,385,221,256,4736,4852,5054
E02005242,Earby & Salterforth,312,130,398,327,391,370,372,395,436,485,514,405,434,279,306,5112,5242,5554
E02005243,Colne Horsfield,221,106,364,363,380,347,297,323,350,429,379,311,329,196,284,4352,4458,4679
E02005244,Colne Vivary Bridge,354,150,473,369,480,428,363,354,424,408,382,279,311,188,271,4730,4880,5234
E02005245,"East Colne, Foulridge & Trawden",306,138,439,307,363,423,378,489,583,618,573,453,483,365,348,5822,5960,6266
E02005246,Colne Waterside,286,131,441,414,469,398,335,392,416,426,359,277,249,185,229,4590,4721,5007
E02005247,"Barrowford, Higham & Pendleside",416,205,556,448,538,565,577,696,776,819,747,701,774,594,627,8418,8623,9039
E02005248,Nelson Bradley,600,277,814,598,682,668,637,508,449,356,363,333,245,150,199,6002,6279,6879
E02005249,Nelson East,756,360,1079,910,1010,1003,881,728,639,557,523,439,347,231,283,8630,8990,9746
E02005250,Nelson West,761,338,982,727,839,872,834,611,597,425,404,326,258,147,238,7260,7598,8359
E02005251,Marsden,453,218,618,434,563,532,486,407,477,438,402,346,397,285,386,5771,5989,6442
E02005252,Brierfield & Reedley,684,315,1023,761,820,875,759,637,659,586,565,497,496,377,438,8493,8808,9492
E02005253,Grimsargh & Goosnargh,336,164,513,444,462,453,437,473,565,616,442,402,450,325,377,5959,6123,6459
E02005254,Broughton & Wychnor,549,241,635,521,658,671,676,629,719,674,581,520,513,366,461,7624,7865,8414
E02005255,Fulwood,505,234,680,545,609,635,660,634,667,697,635,499,555,442,628,7886,8120,8625
E02005256,Longsands,362,178,509,380,440,450,457,525,642,584,510,340,314,239,409,5799,5977,6339
E02005257,Ingol,297,140,388,372,438,453,395,361,341,428,367,310,319,209,301,4682,4822,5119
E02005258,Cadley & College,489,252,686,545,511,551,549,563,595,594,559,448,465,373,593,7032,7284,7773
E02005259,Brookfield & Holme Slack,722,272,954,715,841,856,747,689,723,681,580,482,445,290,461,8464,8736,9458
E02005260,Haslam Park,339,160,487,404,452,472,350,375,562,604,498,377,386,328,468,5763,5923,6262
E02005261,Ribbleton,745,355,975,736,939,897,758,750,778,668,561,432,361,214,294,8363,8718,9463
E02005262,Lea & Marina,300,151,494,572,630,512,463,498,569,616,499,323,278,182,218,5854,6005,6305
E02005263,Moor Park,386,194,1198,916,720,661,592,516,509,404,290,232,159,109,160,6466,6660,7046
E02005264,Plungington & University,440,251,3203,1865,1276,993,801,733,707,602,493,388,277,190,224,11752,12003,12443
E02005265,Ashton-on-Ribble & Larches,564,273,893,822,938,901,780,705,782,798,659,541,463,339,472,9093,9366,9930
E02005266,St Matthew's,556,268,1117,1121,1178,1054,832,741,549,479,401,291,219,123,157,8262,8530,9086
E02005267,St George's,285,146,2479,995,627,560,488,408,336,309,231,178,127,74,108,6920,7066,7351
E02005268,Frenchwood & Fishwick,647,269,1000,830,940,863,820,709,640,582,480,391,264,186,282,7987,8256,8903
E02005269,Preston Town Centre,396,209,2452,1919,1426,1038,796,707,652,612,480,341,265,139,220,11047,11256,11652
E02005270,"Waddington, Gisburn & Slaidburn",542,326,646,293,332,312,313,436,676,753,750,573,529,441,477,6531,6857,7399
E02005271,Clitheroe North,433,214,588,473,561,521,508,521,623,648,541,442,488,380,561,6855,7069,7502
E02005272,Clitheroe South,429,196,588,495,663,695,604,583,674,593,574,461,528,348,517,7323,7519,7948
E02005273,"Longridge North, Ribchester & Chipping",252,110,410,323,300,310,321,349,492,560,504,420,388,310,397,5084,5194,5446
E02005274,"Read, Sabden & Chatburn",368,176,522,367,448,435,482,552,651,747,623,464,553,418,456,6718,6894,7262
E02005275,Longridge South,292,129,400,368,410,333,313,376,466,435,406,389,371,293,344,4904,5033,5325
E02005276,Whalley & Brockhall,428,237,687,471,493,504,625,667,843,842,655,553,544,426,534,7844,8081,8509
E02005277,Wilpshire & Mellor,379,214,601,401,394,412,415,530,776,775,761,620,617,557,678,7537,7751,8130
E02005278,"Crawshawbooth, Reedsholme & Water",390,230,524,426,510,481,538,646,676,640,540,513,478,274,300,6546,6776,7166
E02005279,Haslingden,578,262,865,706,793,794,667,666,761,746,620,478,475,329,408,8308,8570,9148
E02005280,Bacup,628,254,830,698,787,767,781,720,864,817,688,603,526,343,353,8777,9031,9659
E02005281,Rawtenstall,472,210,685,588,798,656,594,621,614,613,551,463,433,316,380,7312,7522,7994
E02005284,Helmshore,303,165,372,292,311,354,399,430,501,500,370,392,430,326,378,5055,5220,5523
E02005285,Townsend Fold & Edenfield,290,125,362,344,378,409,417,483,497,512,457,368,438,318,360,5343,5468,5758
E02005286,Whitworth,388,155,561,488,527,476,480,521,670,675,539,437,456,309,384,6523,6678,7066
E02006884,Waterfoot & Stacksteads,649,293,937,769,870,846,797,786,1044,939,836,696,698,449,513,10180,10473,11122
E02005287,Penwortham North,254,142,382,214,324,311,331,396,446,457,383,324,329,258,348,4503,4645,4899
E02005288,Gregson Lane & Coupe Green,241,113,366,293,364,313,333,364,476,548,424,403,395,350,360,4989,5102,5343
E02005289,Penwortham South,250,117,410,298,330,316,376,392,447,486,473,423,463,335,405,5154,5271,5521
E02005290,Walton-le-Dale,325,163,503,406,439,405,434,555,636,609,483,380,370,275,306,5801,5964,6289
E02005291,Lower Penwortham North,292,127,399,345,430,363,386,407,463,447,402,308,334,243,285,4812,4939,5231
E02005292,Lower Penwortham South,298,136,381,340,423,391,362,362,392,410,378,320,334,230,304,4627,4763,5061
E02005293,Bamber Bridge West,236,100,324,357,382,350,321,358,385,401,336,312,340,236,381,4483,4583,4819
E02005294,Bamber Bridge East,395,180,533,502,634,531,459,494,588,493,376,300,318,229,307,5764,5944,6339
E02005295,Lostock Hall,333,180,498,424,509,495,465,505,653,635,505,421,401,315,394,6220,6400,6733
E02005296,New Longton & Hutton,313,146,403,288,294,288,366,406,518,514,429,410,480,360,460,5216,5362,5675
E02005297,Longton & Walmer Bridge,338,173,567,371,459,466,435,512,650,785,618,541,642,538,672,7256,7429,7767
E02005298,Farington,384,150,567,560,618,591,484,565,582,615,474,464,465,302,355,6642,6792,7176
E02005299,Leyland North,353,169,617,555,660,594,552,545,576,576,407,343,324,230,279,6258,6427,6780
E02005300,Moss Side,250,122,343,287,341,293,307,341,377,431,376,354,339,188,192,4169,4291,4541
E02005301,Leyland South West,272,158,499,377,419,387,357,372,472,527,405,371,370,295,407,5258,5416,5688
E02005302,Leyland South East & Buckshaw Village,408,175,488,376,484,623,596,560,568,518,477,414,466,361,405,6336,6511,6919
E02005303,Seven Stars,405,156,519,430,462,439,413,407,445,433,394,349,349,223,298,5161,5317,5722
E02005304,Hesketh Bank & Tarleton,428,216,599,443,531,498,498,621,672,769,710,583,667,531,533,7655,7871,8299
E02005305,Rufford & Banks,335,165,513,384,436,415,373,449,650,769,757,690,633,471,513,7053,7218,7553
E02005306,"Scarisbrick, Halsall & Haskayne",305,162,490,349,372,371,376,394,641,738,660,590,614,422,504,6521,6683,6988
E02005307,Burscough,478,213,713,526,591,597,599,654,815,722,629,539,597,450,548,7980,8193,8671
E02005308,"Parbold, Appley Bridge & Wrightington",314,139,430,302,288,332,381,494,520,661,496,439,514,437,472,5766,5905,6219
E02005309,Ormskirk North & West,382,191,724,512,551,531,451,520,642,676,621,510,554,427,590,7309,7500,7882
E02005310,Ormskirk Town & East,261,126,1950,493,389,433,384,384,474,455,435,363,434,357,540,7091,7217,7478
E02005311,Bickerstaffe & Newburgh,205,116,864,337,285,295,263,350,430,539,463,435,410,338,414,5423,5539,5744
E02005312,Skelmersdale Ashurst,275,157,486,416,392,433,368,394,467,574,499,434,397,221,266,5347,5504,5779
E02005313,Skelmersdale Central,540,248,812,633,762,768,632,583,665,603,503,392,321,228,281,7183,7431,7971
E02005314,Skelmersdale West,292,156,553,410,454,435,365,405,496,526,424,337,298,251,340,5294,5450,5742
E02005315,Aughton,398,196,571,377,345,378,485,550,613,688,604,528,589,520,783,7031,7227,7625
E02005316,Skelmersdale East,394,180,587,491,532,555,392,468,548,448,312,274,253,208,208,5276,5456,5850
E02005317,Skelmersdale South East,484,194,676,625,648,570,534,471,573,508,389,284,278,200,158,5914,6108,6592
E02005318,Upholland,361,177,541,385,462,424,437,524,671,689,476,472,464,346,520,6411,6588,6949
E02005319,Fleetwood Town,366,182,652,609,701,641,534,568,649,680,566,507,438,319,414,7278,7460,7826
E02005320,Fleetwood Warren,305,144,409,278,365,349,323,340,393,441,391,344,335,269,451,4688,4832,5137
E02005321,Fleetwood Rossall & Chatsworth,411,327,497,328,308,308,291,330,340,425,452,445,454,400,512,5090,5417,5828
E02005322,"Preesall, Stalmine & Hambleton",402,200,581,435,469,443,479,539,754,848,926,924,1068,789,946,9201,9401,9803
E02005323,Fleetwood South East,453,213,596,423,517,515,473,468,502,584,523,447,465,311,334,6158,6371,6824
E02005324,"Bonds, Bilsborrow & Wyresdale",316,174,558,390,355,357,390,434,539,619,521,433,473,318,457,5844,6018,6334
E02005325,Garstang & Catterall,366,176,535,428,458,490,477,520,638,762,772,765,846,713,923,8327,8503,8869
E02005326,Cleveleys West,314,140,512,500,460,433,402,471,649,714,656,636,720,522,758,7433,7573,7887
E02005327,"Pilling, Great Eccleston & Inskip",280,137,409,341,349,372,374,381,525,654,586,492,516,380,420,5799,5936,6216
E02005328,Cleveleys East,262,124,455,399,424,397,363,429,538,640,653,588,674,513,639,6712,6836,7098
E02005329,Thornton West,458,186,670,554,674,596,572,568,687,750,623,501,526,399,568,7688,7874,8332
E02005330,Thornton East & Carleton West,390,195,517,361,393,450,447,553,712,717,716,669,736,560,667,7498,7693,8083
E02005331,Poulton North & Carleton East,360,176,457,406,553,515,527,490,627,649,565,542,620,455,718,7124,7300,7660
E02005332,Poulton South,367,205,538,442,498,477,437,471,680,768,715,604,638,509,729,7506,7711,8078
E02000984,Dunscar & Egerton,378,181,526,423,436,476,510,565,640,633,500,441,552,390,350,6442,6623,7001
E02000985,Bromley Cross & Bradshaw,399,187,516,333,358,405,431,515,637,609,528,444,563,434,577,6350,6537,6936
E02000986,Eagley & Sharples,446,209,637,480,581,551,513,561,653,673,531,434,460,361,509,6944,7153,7599
E02000987,Horwich North,343,160,649,503,571,522,478,488,661,634,501,377,419,328,397,6528,6688,7031
E02000988,Astley Bridge & Waters Meeting,565,246,828,752,698,742,675,641,630,604,512,412,369,253,368,7484,7730,8295
E02000989,Harwood,366,178,525,413,483,486,424,496,641,657,552,529,656,573,756,7191,7369,7735
E02000990,Horwich South & Middlebrook,388,180,588,560,640,671,552,543,622,664,565,468,510,356,325,7064,7244,7632
E02000991,Smithills,449,198,601,520,639,650,531,536,562,617,506,404,373,295,347,6581,6779,7228
E02000992,Blackrod & Butterwick Fields,289,126,426,367,419,406,396,440,506,463,387,353,381,346,403,5293,5419,5708
E02000993,Hall I' th' Wood,545,233,780,706,844,693,578,522,532,522,377,339,272,149,178,6492,6725,7270
E02000994,Halliwell & Brownlow Fold,658,285,987,714,761,889,695,667,556,537,426,341,279,179,197,7228,7513,8171
E02000995,Doffcocker & Moss Bank,505,276,586,475,553,584,532,563,595,567,551,428,483,324,499,6740,7016,7521
E02000996,Breightmet North,611,297,770,581,726,666,601,525,570,548,422,325,339,234,362,6669,6966,7577
E02000997,Horwich East,291,138,455,396,466,429,426,436,492,497,434,383,384,296,387,5481,5619,5910
E02000998,Gilnow & Victory,713,335,1153,907,969,1031,886,712,713,569,476,393,314,198,240,8561,8896,9609
E02000999,Central Bolton,474,238,1108,848,795,770,625,641,588,481,459,355,270,172,226,7338,7576,8050
E02001000,Tonge,467,226,762,817,937,789,653,645,724,698,549,468,448,338,452,8280,8506,8973
E02001001,Heaton & Deane,566,285,909,637,671,712,688,627,627,528,468,374,319,244,325,7129,7414,7980
E02001002,Breightmet South & Darcy Lever,558,271,732,572,703,771,606,626,697,712,569,527,590,390,359,7854,8125,8683
E02001003,Lostock & Ladybridge,450,224,580,389,394,420,540,497,552,512,509,450,522,418,519,6302,6526,6976
E02001004,Rumworth North,678,348,1080,703,806,865,773,719,624,506,458,312,243,166,223,7478,7826,8504
E02001005,Burnden & Great Lever,712,314,1147,931,966,873,816,649,598,502,462,376,289,158,275,8042,8356,9068
E02001006,Rumworth South,611,234,867,717,884,768,734,629,574,491,423,289,231,146,208,6961,7195,7806
E02001007,Little Lever,552,238,748,549,607,617,619,728,822,685,615,657,823,600,456,8526,8764,9316
E02001008,Lever Edge,805,344,1070,686,796,794,740,659,563,413,399,311,247,201,337,7216,7560,8365
E02001009,Daubhill & Fernhill Gate,472,205,693,501,657,656,565,497,563,461,378,351,310,262,323,6217,6422,6894
E02001010,Farnworth North,407,202,647,547,657,544,477,413,438,398,332,268,219,148,231,5319,5521,5928
E02001011,Westhoughton East,438,199,660,533,626,662,594,687,743,768,683,639,622,451,474,8142,8341,8779
E02001012,Harper Green,673,310,857,619,719,708,631,575,577,512,453,334,310,237,244,6776,7086,7759
E02001013,Over Hulton,313,148,471,297,381,403,426,409,495,471,369,355,317,337,415,5146,5294,5607
E02001014,Westhoughton West,417,222,631,572,622,619,530,574,675,655,568,471,459,318,360,7054,7276,7693
E02001015,Farnworth South,397,180,684,609,676,603,548,525,596,639,503,406,435,320,348,6892,7072,7469
E02001016,Highfield & New Bury,646,276,860,629,773,706,565,622,705,581,402,305,339,202,210,6899,7175,7821
E02001017,Kearsley & Stoneclough,598,273,868,639,796,744,652,735,913,862,624,528,564,417,413,8755,9028,9626
E02001018,Westhoughton Daisy Hill,393,197,627,452,531,505,489,533,688,713,503,457,409,234,208,6349,6546,6939
E02001019,Ramsbottom,466,228,605,505,586,619,618,720,783,710,585,484,496,380,421,7512,7740,8206
E02001020,Summerseat,292,138,391,216,209,329,359,438,447,469,365,392,566,416,488,5085,5223,5515
E02001021,Nuttall & Tottington,322,170,528,386,410,429,432,516,687,715,628,462,445,338,421,6397,6567,6889
E02001022,Walmersley & Limefield,403,196,617,457,519,541,503,489,563,643,571,444,499,371,482,6699,6895,7298
E02001023,Higher Woodhill,339,128,470,352,394,417,390,393,420,402,362,360,396,278,260,4894,5022,5361
E02001024,Walshaw & Woolfold,422,205,639,442,537,513,484,611,675,632,494,450,508,363,362,6710,6915,7337
E02001025,Fairfield & Jericho,445,222,664,571,728,631,541,529,587,637,473,368,355,249,312,6645,6867,7312
E02001026,Fernhill & Pimhole,722,283,1179,1075,1117,1095,974,764,748,688,530,430,312,221,236,9369,9652,10374
E02001027,Whitehead Park,371,170,569,570,661,587,526,566,513,496,385,281,312,181,291,5938,6108,6479
E02001028,Elton Vale,326,178,470,329,367,405,448,470,542,575,513,520,612,545,654,6450,6628,6954
E02001029,Buckley Wells & Fishpool,471,217,769,632,656,670,600,555,543,515,437,344,293,187,260,6461,6678,7149
E02001030,Ainsworth & Bradley Fold,282,168,464,404,387,416,365,411,540,572,426,383,352,245,230,5195,5363,5645
E02001031,Redvales & Hollins,374,181,528,453,493,518,486,486,523,491,432,334,336,270,310,5660,5841,6215
E02001032,Black Lane,365,182,585,503,594,535,468,496,585,556,475,406,435,373,337,6348,6530,6895
E02001033,Bank Top & Radcliffe Ees,311,155,530,492,562,514,407,396,442,475,326,259,265,148,182,4998,5153,5464
E02001034,Radcliffe,468,219,695,713,752,719,599,548,619,608,511,377,361,254,357,7113,7332,7800
E02001035,Unsworth,368,184,527,383,415,483,464,490,582,602,473,416,451,379,523,6188,6372,6740
E02001036,Outwood Gate,443,218,629,511,588,631,557,490,523,530,408,331,384,207,237,6026,6244,6687
E02001037,Whitefield West & Park Lane,323,164,416,374,441,522,497,520,497,544,489,474,487,388,543,6192,6356,6679
E02001038,Whitefield East,240,116,363,418,552,489,391,380,414,400,365,289,274,194,301,4830,4946,5186
E02001039,Besses,599,250,793,613,742,704,683,574,619,600,451,307,306,222,315,6929,7179,7778
E02001040,Kirkhams & Holyrood,290,151,418,382,572,541,471,425,446,481,439,327,343,264,333,5442,5593,5883
E02001041,Prestwich East,379,186,615,634,824,750,623,534,516,597,439,344,342,225,358,6801,6987,7366
E02001042,Prestwich Central,338,145,497,447,556,579,468,477,485,523,424,365,334,246,284,5685,5830,6168
E02001043,Prestwich Clough & Rainsough,270,137,410,392,481,525,425,418,419,427,368,260,222,186,294,4827,4964,5234
E02001044,Sedgley Park,910,319,955,653,755,737,703,526,533,451,436,371,306,210,259,6895,7214,8124
E02001045,Boothroyden & Higher Blackley,560,259,779,600,715,711,679,580,639,584,521,409,395,245,279,7136,7395,7955
E02001046,Blackley,780,347,1080,909,1057,1120,990,905,820,714,563,391,337,244,278,9408,9755,10535
E02001047,Charlestown,646,332,936,768,814,893,829,791,809,752,599,446,396,277,369,8679,9011,9657
E02001048,Crumpsall North & Heaton Park,619,296,850,728,894,886,745,626,599,592,487,347,320,207,305,7586,7882,8501
E02001049,New Moston,631,296,829,694,815,768,731,643,791,791,630,495,464,310,463,8424,8720,9351
E02001050,Hapurhey North,672,287,860,713,834,868,842,723,641,528,403,284,245,163,176,7280,7567,8239
E02001051,Moston West,762,283,899,683,796,832,810,775,739,601,536,363,273,192,251,7750,8033,8795
E02001052,Crumpsall South,1309,618,1863,1427,1692,1714,1524,1341,1028,777,649,504,324,221,348,13412,14030,15339
E02001053,Hapurhey South & Monsall,951,400,1203,965,1135,1118,1013,986,912,720,532,398,309,179,232,9702,10102,11053
E02001055,Newton Heath,632,262,771,743,890,778,731,631,653,609,537,403,354,269,268,7637,7899,8531
E02001056,Clayton Vale,731,365,976,627,695,789,735,698,692,581,448,356,282,193,200,7272,7637,8368
E02001057,New Islington & Miles Platting,505,229,1635,3069,2418,1600,1027,747,625,562,482,325,241,130,157,13018,13247,13752
E02001059,"Beswick, Eastlands & Openshaw Park",871,341,1171,1267,1381,1313,1148,973,806,707,531,389,276,184,215,10361,10702,11573
E02001061,Openshaw & Gorton North,831,386,1071,877,1029,1033,996,866,807,727,613,434,350,211,274,9288,9674,10505
E02001062,Ardwick,766,339,3013,2475,1736,1272,1026,913,778,618,441,271,178,145,186,13052,13391,14157
E02001063,Hulme & University,483,214,5575,2930,1787,1300,892,636,552,429,285,143,92,63,89,14773,14987,15470
E02001064,Belle Vue & West Gorton,778,384,1113,947,1080,1089,970,882,800,722,553,369,242,188,281,9236,9620,10398
E02001065,Abbey Hey,645,244,856,844,853,878,794,713,712,634,446,369,293,203,222,7817,8061,8706
E02001066,Victoria Park,556,294,3958,2220,1718,1257,1135,861,653,533,384,240,180,119,177,13435,13729,14285
E02001067,Gorton South,974,413,1292,941,1001,1041,1103,904,812,691,450,356,245,169,188,9193,9606,10580
E02001068,Moss Side West,1016,458,1641,1309,1203,1187,1009,884,798,713,446,300,204,154,295,10143,10601,11617
E02001069,Rusholme West & Moss Side East,722,339,3087,2252,1995,1591,1307,1041,629,480,329,235,177,137,181,13441,13780,14502
E02001070,Rusholme East,552,356,6624,2231,1448,1123,940,704,572,449,383,284,195,119,178,15250,15606,16158
E02001071,Levenshulme North,1394,641,1884,1411,1754,1823,1776,1417,1204,861,566,432,318,192,251,13889,14530,15924
E02001072,Whalley Range North,463,232,909,1104,1192,1168,1098,817,730,595,429,322,176,126,203,8869,9101,9564
E02001073,Chorlton North,443,185,682,1147,1189,1037,897,705,792,691,529,403,313,185,333,8903,9088,9531
E02001074,Fallowfield West & Whalley Range South,853,389,1388,1203,1238,1187,1010,899,850,805,671,439,301,207,396,10594,10983,11836
E02001075,Levenshulme Central,612,312,908,932,1102,1107,1024,774,695,514,356,266,180,112,130,8100,8412,9024
E02001076,Fallowfield Central,253,165,6004,1517,911,719,621,517,394,307,231,182,142,75,126,11746,11911,12164
E02001077,Chorlton South,359,176,575,810,850,776,718,627,586,533,383,371,269,196,206,6900,7076,7435
E02001078,Levenshulme South & Burnage North,696,286,1188,861,962,1103,977,807,733,592,534,475,375,269,386,9262,9548,10244
E02001079,Withington North & Old Moat,585,261,1592,1008,962,875,732,673,547,544,449,311,226,172,234,8325,8586,9171
E02001080,Ladybarn,240,125,2977,1153,989,808,649,465,347,347,321,253,187,170,200,8866,8991,9231
E02001081,Beech Road & Chorlton Meadows,298,130,399,510,644,647,649,484,530,459,348,276,247,147,179,5519,5649,5947
E02001082,Withington West,238,90,1041,1142,888,747,551,444,402,341,255,242,200,109,163,6525,6615,6853
E02001083,West Didsbury,294,138,815,1525,1229,1003,861,632,540,375,287,197,158,101,134,7857,7995,8289
E02001084,Withington East,384,172,1357,1010,900,809,738,584,528,511,409,307,285,172,253,7863,8035,8419
E02001085,Burnage South,684,311,905,689,776,855,706,625,636,589,460,330,251,186,212,7220,7531,8215
E02001086,Merseybank & Barlow Moor,408,186,781,870,866,750,680,574,534,481,363,258,228,183,284,6852,7038,7446
E02001087,Didsbury Village,419,190,683,1022,1009,990,888,827,726,667,500,455,425,317,397,8906,9096,9515
E02001088,Northern Moor,594,231,776,678,887,871,748,636,586,596,495,384,332,204,295,7488,7719,8313
E02001089,East Didsbury,429,214,722,750,845,826,794,580,595,551,478,399,349,224,366,7479,7693,8122
E02001090,Northenden,270,121,452,458,596,626,517,480,543,522,486,404,329,229,304,5946,6067,6337
E02001091,Baguley West & Brooklands,392,182,559,611,719,741,617,618,594,611,525,459,419,313,323,7109,7291,7683
E02001092,Baguley East & Wythenshawe Park,526,202,733,724,914,851,716,560,621,611,534,373,323,190,241,7391,7593,8119
E02001093,Benchill North & Sharston,667,291,861,846,1051,995,770,645,672,542,488,393,336,236,287,8122,8413,9080
E02001094,Benchill South & Wythenshawe Central,749,317,921,825,1043,1047,808,681,627,532,520,382,318,184,188,8076,8393,9142
E02001095,Newall Green,532,247,819,761,923,847,714,637,666,605,494,407,356,218,218,7665,7912,8444
E02001096,Wythenshawe East & Peel Hall,427,190,666,588,689,698,585,522,602,612,500,454,380,205,270,6771,6961,7388
E02001097,Woodhouse Park & Airport,533,254,812,777,972,927,716,606,605,643,493,386,323,184,235,7679,7933,8466
E02006902,City Centre North & Collyhurst,208,154,1492,2052,1493,1030,630,382,321,244,169,118,70,45,45,8091,8245,8453
E02006912,Piccadilly & Ancoats,44,99,6192,4572,2093,1155,694,424,285,216,175,137,108,62,114,16227,16326,16370
E02006913,Cheetham Hill,490,220,1090,1358,1279,1010,718,565,496,387,309,173,134,99,114,7732,7952,8442
E02006914,University North & Whitworth Street,72,42,4867,2609,1106,603,383,255,220,164,103,57,29,28,28,10452,10494,10566
E02006915,Strangeways,766,304,1146,1147,1179,1192,1006,818,657,501,354,272,158,110,113,8653,8957,9723
E02006916,Hulme Park & St George's,140,76,1108,1643,1170,843,544,389,335,298,183,108,80,44,59,6804,6880,7020
E02006917,Castlefield & Deansgate,32,22,1826,1732,1188,741,446,254,221,176,102,83,44,30,18,6861,6883,6915
E02001098,Shaw & Crompton,276,122,388,287,353,349,335,338,456,512,447,377,491,402,407,5142,5264,5540
E02001099,Wood End,263,102,423,412,449,409,355,355,450,488,384,303,310,240,265,4843,4945,5208
E02001100,Clough & Shaw Side,267,141,437,313,382,397,370,367,486,456,418,375,431,333,415,5180,5321,5588
E02001101,Royton North,268,141,401,291,371,331,337,394,491,434,405,401,439,335,288,4918,5059,5327
E02001102,Royton East & Cowlishaw,304,134,413,384,478,439,366,405,504,508,390,314,324,203,204,4932,5066,5370
E02001103,"Diggle, Delph & Denshaw",261,129,369,234,231,302,324,393,491,527,400,384,410,297,374,4736,4865,5126
E02001104,Moorside & Sholver,432,192,618,506,595,516,468,537,598,515,422,315,334,192,214,5830,6022,6454
E02001105,Royton South West,297,128,447,332,346,366,346,382,465,456,406,349,422,351,339,5007,5135,5432
E02001106,Royton South East,251,148,443,394,410,397,384,385,448,495,394,310,364,286,384,5094,5242,5493
E02001107,Chadderton North,448,239,635,464,509,529,522,454,464,410,336,279,291,221,274,5388,5627,6075
E02001108,Derker,402,178,532,443,508,489,396,343,351,383,273,193,181,122,183,4397,4575,4977
E02001109,Waterhead,356,179,650,594,622,542,499,475,614,605,474,365,349,212,273,6274,6453,6809
E02001110,"New Delph, Dobcross & Austerlands",285,160,368,263,344,368,381,477,534,577,509,442,461,367,384,5475,5635,5920
E02001111,Oldham Town North,626,323,964,698,741,765,666,654,576,497,365,295,207,150,214,6792,7115,7741
E02001112,Middleton Junction,284,135,416,344,410,480,391,351,464,471,448,459,435,250,254,5173,5308,5592
E02001113,Busk,731,349,1296,910,860,781,793,664,521,358,283,229,156,129,185,7165,7514,8245
E02001114,Chadderton Central,545,260,817,575,631,642,658,601,602,523,468,389,382,350,383,7021,7281,7826
E02001115,Lees & Hey,272,119,433,393,490,396,333,395,435,450,397,324,324,259,275,4904,5023,5295
E02001116,Salem,657,273,720,613,728,722,629,531,390,362,302,269,199,122,151,5738,6011,6668
E02001117,Greenfield & Uppermill,282,145,416,238,313,370,380,451,527,503,409,420,455,330,362,5174,5319,5601
E02001118,Springhead & Grasscroft,284,140,467,302,326,381,358,402,512,537,474,375,385,307,410,5236,5376,5660
E02001119,Alexandra Park,1001,442,1600,1092,1130,1047,1015,760,619,441,412,414,204,151,319,9204,9646,10647
E02001121,Oldham Town South,702,357,1010,678,712,796,687,550,479,338,325,238,148,106,140,6207,6564,7266
E02001123,Alt,501,223,592,515,578,557,514,450,480,440,358,278,265,168,212,5407,5630,6131
E02001124,Chadderton South East,410,195,618,506,610,546,468,417,442,424,301,272,234,173,202,5213,5408,5818
E02001125,Chadderton South West,435,185,620,558,666,621,489,490,586,610,505,403,374,254,369,6545,6730,7165
E02001126,Hathershaw,667,283,901,696,801,750,684,601,602,497,463,324,241,172,228,6960,7243,7910
E02001127,Lime Side & Garden Suburb,534,265,756,597,624,635,556,473,523,514,398,342,301,178,195,6092,6357,6891
E02001128,Failsworth East,406,185,632,552,608,548,447,503,590,574,482,374,383,291,318,6302,6487,6893
E02001129,Failsworth West,325,140,514,570,650,537,458,453,458,415,334,295,305,175,276,5440,5580,5905
E02001130,Holt Lane End & Bardsley,266,140,450,348,343,340,339,334,486,562,437,341,310,255,315,4860,5000,5266
E02001131,Failsworth South,264,122,403,346,412,352,322,323,459,443,354,259,261,266,325,4525,4647,4911
E02006860,Werneth,1338,649,1997,1339,1428,1452,1451,1154,961,644,599,535,333,207,377,12477,13126,14464
E02001132,Littleborough North & Calderbook,311,155,451,426,465,453,403,458,561,536,406,376,383,288,325,5531,5686,5997
E02001133,Littleborough West & Wardle,362,161,473,357,463,478,441,486,508,510,397,407,418,296,240,5474,5635,5997
E02001134,Littleborough South & Smithy Bridge,281,125,406,380,390,392,414,425,536,568,455,399,416,348,328,5457,5582,5863
E02001135,Hurstead & Smallbridge,681,274,835,612,682,702,635,560,571,477,408,276,315,241,235,6549,6823,7504
E02001136,"Healey, Syke & Shawclough",490,215,756,657,712,683,622,649,704,679,624,558,522,367,455,7988,8203,8693
E02001137,Hooley Bridge & Norden West,276,158,441,345,371,385,340,430,561,546,433,417,393,259,255,5176,5334,5610
E02001138,Norden East & Bagslate Moor,397,215,614,484,518,467,519,489,709,761,650,544,600,452,571,7378,7593,7990
E02001139,Wardleworth & Newbold Brow,773,376,1206,881,968,995,873,712,596,448,438,401,242,157,204,8121,8497,9270
E02001140,Spotland Bridge,549,256,697,563,748,670,557,548,546,499,372,337,300,189,347,6373,6629,7178
E02001141,Central Rochdale & Mandale Park,879,417,1325,1006,1157,1211,1131,1014,929,698,608,464,366,210,299,10418,10835,11714
E02001142,Springfield Park,302,164,416,301,308,324,374,353,464,458,429,389,423,353,451,5043,5207,5509
E02001143,Kingsway,883,395,1277,947,977,937,942,849,845,682,499,437,339,231,290,9252,9647,10530
E02001144,Milnrow West,315,151,491,472,484,432,389,433,474,494,427,336,366,260,264,5322,5473,5788
E02001145,Milnrow East & Newhey,337,176,512,425,480,470,442,495,601,577,466,411,455,344,305,5983,6159,6496
E02001146,Deeplish,742,346,1167,868,960,898,893,714,666,478,499,389,237,165,279,8213,8559,9301
E02001147,Balderstone & Kirkholt,685,312,870,739,874,816,743,681,739,636,562,411,371,245,295,7982,8294,8979
E02001148,Castleton & Trub,570,259,777,695,842,757,664,720,702,749,624,541,611,404,507,8593,8852,9422
E02001149,Heywood Town,509,228,846,786,905,842,726,673,706,725,653,537,512,319,407,8637,8865,9374
E02001150,Heywood Heap Bridge & Darnhill,530,233,710,614,775,699,591,571,652,687,574,474,420,249,322,7338,7571,8101
E02001151,Heywood Hopwood & Siddal Moor,493,256,786,639,781,734,703,699,718,734,620,518,549,387,426,8294,8550,9043
E02001152,North Middleton & Stakehill,555,266,829,746,887,856,719,665,753,708,626,545,452,285,326,8397,8663,9218
E02001153,Langley & Wood Side,808,353,931,918,1235,1172,959,787,822,731,708,535,478,287,330,9893,10246,11054
E02001154,Middleton East,553,242,852,713,858,818,732,648,682,784,687,548,444,254,372,8392,8634,9187
E02001155,Middleton Town & Rhodes,338,167,497,444,580,580,540,489,548,569,511,423,365,240,330,6116,6283,6621
E02001156,Alkrington,483,226,737,578,643,726,683,637,715,785,686,585,547,409,655,8386,8612,9095
E02001157,Little Hulton North,612,282,803,682,781,746,535,546,551,501,429,321,296,184,281,6656,6938,7550
E02001158,Walkden North West,345,148,520,487,570,511,378,386,433,406,393,274,284,166,261,5069,5217,5562
E02001159,Walkden North East,371,172,576,605,779,659,557,474,468,494,317,251,244,179,184,5787,5959,6330
E02001160,Little Hulton South,469,190,618,563,710,685,505,499,451,412,376,282,292,185,241,5819,6009,6478
E02001161,Clifton,252,127,400,448,474,469,415,336,442,462,463,342,288,220,336,5095,5222,5474
E02001162,Swinton Newtown,272,145,457,434,508,447,393,391,402,416,361,281,359,259,348,5056,5201,5473
E02001163,Walkden South,459,190,658,703,928,776,579,624,650,709,627,471,547,418,493,8183,8373,8832
E02001164,Clifton Green & Pendlebury East,401,153,970,946,1150,983,769,539,582,468,349,247,246,149,167,7565,7718,8119
E02001165,Swinton West,354,148,475,485,554,542,405,402,476,439,380,272,246,210,252,5138,5286,5640
E02001166,Broughton Park,698,299,1077,631,512,498,451,381,350,357,320,306,297,198,284,5662,5961,6659
E02001167,Kersal Dale,494,249,986,631,716,704,585,472,468,416,358,296,295,184,242,6353,6602,7096
E02001168,Swinton Worsley Road,483,239,801,802,958,869,759,684,716,643,620,481,456,299,403,8491,8730,9213
E02001169,Ellenbrook & Boothstown,517,239,734,656,711,820,750,742,858,839,774,638,680,470,493,9165,9404,9921
E02001170,Worsley,486,223,593,469,688,671,738,745,846,712,600,491,584,474,691,8302,8525,9011
E02001171,Swinton South East & Pendlebury West,275,117,439,416,486,461,446,406,417,476,419,323,349,253,323,5214,5331,5606
E02001172,Higher Broughton,1261,461,1951,1866,1870,1714,1389,975,862,679,545,467,367,263,372,13320,13781,15042
E02001173,Cromwell Road & Broad Street,502,210,1528,1135,1050,839,721,562,549,478,373,245,238,162,172,8052,8262,8764
E02001174,Lightoaks,216,110,565,523,556,532,421,356,392,372,334,282,279,185,259,5056,5166,5382
E02001175,Winton & Westwood,429,198,621,607,724,699,540,527,537,546,411,290,263,199,250,6214,6412,6841
E02001176,Eccles,482,208,838,1023,1118,1039,891,893,809,831,776,569,570,424,661,10442,10650,11132
E02001177,Weaste & Seedley,647,333,1353,1637,1637,1317,1024,837,862,834,681,543,489,344,517,12075,12408,13055
E02001178,Salford Central & University,336,166,4738,4606,3163,2011,1272,883,641,604,441,226,191,91,111,18978,19144,19480
E02001179,Langworthy Buile Hill,309,145,917,1021,958,774,520,402,378,394,352,260,244,166,204,6590,6735,7044
E02001180,Pendleton,243,119,1108,853,818,698,557,403,409,356,248,212,185,103,140,6090,6209,6452
E02001181,Peel Green,359,176,551,517,556,566,446,400,432,408,357,242,215,138,182,5010,5186,5545
E02001182,Barton upon Irwell,341,145,632,707,775,704,519,504,482,453,377,249,230,151,226,6009,6154,6495
E02001183,Patricroft,319,145,604,726,832,649,578,427,476,433,369,255,208,153,188,5898,6043,6362
E02001184,Ordsall & Salford Quays,457,222,3080,3928,2736,1790,1226,834,754,627,477,328,325,178,179,16462,16684,17141
E02001185,Higher Irlam,530,246,802,680,768,685,649,622,707,799,590,468,457,438,540,8205,8451,8981
E02001186,Lower Irlam & Cadishead,577,237,808,781,900,898,726,688,860,755,592,391,441,351,405,8596,8833,9410
E02001187,Reddish Vale View,343,162,510,489,608,571,486,440,521,581,498,373,350,283,289,5999,6161,6504
E02001188,North Reddish,464,219,740,718,832,713,624,563,546,577,433,304,300,176,204,6730,6949,7413
E02001189,Central Reddish,351,171,607,589,763,666,595,557,616,667,557,422,411,298,364,7112,7283,7634
E02001190,Brinnington,499,219,691,744,779,721,533,448,530,426,372,282,227,145,255,6153,6372,6871
E02001191,Woodley,252,101,367,371,406,376,382,374,423,459,425,391,429,280,364,5047,5148,5400
E02001192,Heaton Chapel & Shaw Road,279,145,451,417,610,623,581,512,552,536,372,361,267,204,364,5850,5995,6274
E02001193,South Reddish & Heaton Norris,280,118,484,555,655,583,467,451,492,441,358,262,242,178,227,5395,5513,5793
E02001194,Heaton Moor,330,149,407,374,457,468,543,493,510,457,412,366,335,242,375,5439,5588,5918
E02001195,Bredbury,345,154,480,507,625,601,486,465,558,589,456,422,425,329,398,6341,6495,6840
E02001196,Romiley & Compstall,373,174,511,387,440,527,521,490,589,634,525,469,540,453,598,6684,6858,7231
E02001197,Norris Bank,354,170,402,331,423,506,545,497,505,475,414,367,304,209,252,5230,5400,5754
E02001198,Bredbury Green,395,181,538,409,487,536,435,476,548,523,405,392,427,395,610,6181,6362,6757
E02001199,Heaton Mersey,349,162,511,496,623,693,661,584,559,641,524,438,471,290,378,6869,7031,7380
E02001200,"Central Stockport, Portwood & Shaw Heath",338,134,635,786,866,670,560,501,527,531,439,338,300,180,207,6540,6674,7012
E02001201,Woodbank Park,274,125,382,439,490,465,400,350,441,415,341,271,245,187,241,4667,4792,5066
E02001202,Edgeley,248,118,454,629,791,601,531,418,499,424,304,241,232,137,154,5415,5533,5781
E02001203,Marple Bridge & Mellor,284,126,331,241,290,399,397,429,465,483,489,428,447,364,426,5189,5315,5599
E02001204,Cheadle Heath,456,213,595,598,856,797,701,618,651,626,511,429,379,223,338,7322,7535,7991
E02001205,Heaviley,345,175,631,646,786,663,536,573,655,601,519,386,348,245,291,6880,7055,7400
E02001206,Marple & Rose Hill,375,152,474,380,461,528,524,467,544,572,446,429,470,332,599,6226,6378,6753
E02001207,Offerton East & Bosden Farm,322,133,468,383,480,498,425,428,513,525,594,451,477,293,360,5895,6028,6350
E02001208,Cheadle East,315,163,463,511,671,625,556,520,521,533,483,383,320,252,399,6237,6400,6715
E02001209,Davenport,391,189,539,578,721,697,549,597,621,526,426,341,322,182,305,6404,6593,6984
E02001210,Offerton West,438,221,617,467,554,568,511,485,523,514,422,367,318,285,367,5998,6219,6657
E02001211,Gatley North,308,166,435,360,410,520,553,478,462,446,446,350,353,273,387,5473,5639,5947
E02001212,Adswood,508,224,668,506,642,602,528,494,494,406,319,256,224,151,198,5488,5712,6220
E02001213,Woodsmoor & Mile End,512,232,616,630,850,806,781,703,749,779,658,508,446,366,459,8351,8583,9095
E02001214,Gatley South & Cheadle West,454,184,566,446,502,563,532,551,606,534,509,431,497,381,576,6694,6878,7332
E02001215,Marple & Hawk Green,258,126,343,294,342,384,432,379,430,448,436,404,478,373,482,5225,5351,5609
E02001216,Cheadle Hulme Orrishmere,422,185,486,391,467,592,661,559,583,484,458,437,476,359,509,6462,6647,7069
E02001217,Hazel Grove North,326,151,426,474,679,551,457,438,475,464,391,311,384,274,476,5800,5951,6277
E02001218,Bramhall North West,349,177,404,270,320,354,429,479,482,452,393,381,388,314,413,5079,5256,5605
E02001219,Hazel Grove West,235,119,334,303,330,320,353,339,385,403,335,361,387,321,398,4569,4688,4923
E02001220,Cheadle Hulme West,335,135,389,264,336,417,462,423,429,441,377,320,317,258,301,4734,4869,5204
E02001221,Hazel Grove East & South,275,140,402,315,316,348,364,486,433,476,411,348,379,357,456,5091,5231,5506
E02001222,Heald Green West,368,167,483,373,426,499,553,405,408,388,389,402,439,326,463,5554,5721,6089
E02001223,Bramhall North East,332,167,419,326,353,426,460,479,545,510,541,452,404,374,565,5854,6021,6353
E02001224,High Lane,247,112,385,263,261,254,305,382,470,505,488,406,557,460,631,5367,5479,5726
E02001225,Cheadle Hulme South East,450,211,482,341,403,501,597,590,611,541,505,416,428,356,497,6268,6479,6929
E02001226,Heald Green East,395,181,547,434,512,545,566,472,466,491,395,377,379,255,414,5853,6034,6429
E02001227,Bramhall West,293,124,317,220,248,330,434,405,391,442,365,343,357,364,501,4717,4841,5134
E02001228,Bramhall South & Woodford,262,169,404,289,377,441,438,452,436,485,397,372,354,345,559,5349,5518,5780
E02001229,Mossley,490,235,667,618,823,799,723,763,878,788,656,570,535,363,346,8529,8764,9254
E02001230,Ashton North,287,143,473,369,414,375,371,348,430,501,437,365,415,350,305,5153,5296,5583
E02001231,Carrbrook & Micklehurst,409,195,602,422,485,501,527,542,568,584,432,369,401,230,190,5853,6048,6457
E02001232,Hurst Cross,434,224,732,611,738,685,592,567,623,617,472,351,408,280,297,6973,7197,7631
E02001233,Ashton Waterloo,461,195,612,564,588,611,496,505,545,563,561,472,429,342,346,6634,6829,7290
E02001234,Smallshaw,481,200,752,617,641,652,548,493,556,567,484,346,354,239,293,6542,6742,7223
E02001235,Ashton East,353,175,534,582,650,604,551,539,559,525,427,326,292,236,250,6075,6250,6603
E02001236,Stalybridge North,357,140,510,518,523,514,384,392,455,402,328,256,261,177,249,4969,5109,5466
E02001237,Stalybridge East & Swineshaw,402,173,548,503,601,541,518,522,594,550,414,313,340,196,248,5888,6061,6463
E02001238,Droylsden East,381,190,568,566,598,541,545,501,567,660,597,441,452,304,373,6713,6903,7284
E02001239,Droylsden Central,492,234,713,741,851,742,570,621,748,733,624,422,386,315,368,7834,8068,8560
E02001240,Droylsden West,333,175,561,455,537,480,413,444,507,519,398,319,319,205,246,5403,5578,5911
E02001241,Ashton Central,711,306,1166,951,1073,1030,940,871,801,659,546,433,375,207,220,9272,9578,10289
E02001242,Audenshaw,352,157,489,414,572,549,487,474,497,489,443,375,344,263,336,5732,5889,6241
E02001243,Stalybridge South,332,155,556,556,613,564,555,575,632,614,563,497,558,389,405,7077,7232,7564
E02001244,Dukinfield East & Hough Hill,258,113,398,331,328,369,319,357,471,424,367,347,388,305,268,4672,4785,5043
E02001245,Dukinfield West,362,171,674,632,704,649,567,550,649,613,513,390,363,235,283,6822,6993,7355
E02001246,Newtonmoor,396,182,598,452,547,521,488,445,585,599,441,388,409,256,373,6102,6284,6680
E02001247,Guide Bridge,400,176,527,577,652,594,507,493,552,551,492,377,326,233,308,6189,6365,6765
E02001248,Hyde North,714,294,971,888,1056,993,892,788,816,783,650,488,466,291,277,9359,9653,10367
E02001249,Denton North,287,144,507,535,528,506,427,400,461,475,430,301,281,236,266,5353,5497,5784
E02001250,Godley,281,145,492,375,415,424,398,455,546,547,511,383,417,303,284,5550,5695,5976
E02001251,"Mottram, Hollingworth & Broadbottom",268,134,370,391,413,412,321,387,501,574,443,439,436,281,323,5291,5425,5693
E02001252,Dane Bank,319,172,544,451,511,505,476,465,584,623,555,419,432,322,547,6434,6606,6925
E02001253,Denton West,269,105,382,321,393,355,319,322,426,415,351,276,272,220,256,4308,4413,4682
E02001254,Denton East,285,135,414,390,444,369,334,405,449,454,350,274,348,254,263,4748,4883,5168
E02001255,Hattersley,483,186,587,612,743,678,480,451,531,503,434,285,289,159,240,5992,6178,6661
E02001256,Hyde South,610,295,1000,865,871,845,768,714,775,678,508,411,379,301,455,8570,8865,9475
E02001257,Denton South,467,217,631,588,682,659,529,572,723,745,643,504,545,419,566,7806,8023,8490
E02001258,Cheetham Fold & Gee Cross,357,162,484,401,491,429,487,508,620,593,475,410,475,352,472,6197,6359,6716
E02001259,Old Trafford,688,324,1560,1408,1315,1256,1132,875,779,727,517,363,220,151,300,10603,10927,11615
E02001260,Trafford Park West & Kingsway Park,422,195,544,451,589,583,552,571,613,540,532,393,418,346,366,6498,6693,7115
E02001261,Gorse Hill,532,219,747,738,950,949,786,622,617,600,430,314,253,163,223,7392,7611,8143
E02001262,Firswood,525,264,866,798,827,775,763,612,690,646,512,365,294,197,376,7721,7985,8510
E02001263,Davyhulme,402,175,536,464,546,605,581,587,642,676,565,466,507,438,573,7186,7361,7763
E02001264,Trafford Park East & Sevenways,497,235,702,541,685,776,689,603,709,596,539,345,304,231,311,7031,7266,7763
E02001265,Flixton & Moorside,430,208,632,523,615,626,567,610,607,638,565,452,456,297,393,6981,7189,7619
E02001266,Lostock & Stretford Meadows,356,171,550,423,490,575,515,473,548,566,453,333,328,224,299,5777,5948,6304
E02001267,Urmston East,286,144,465,425,526,626,514,516,555,623,452,358,379,276,483,6198,6342,6628
E02001268,Urmston West,324,157,477,332,439,478,521,495,571,591,481,428,464,349,467,6093,6250,6574
E02001269,Stretford East,468,225,647,592,714,781,739,627,599,580,485,411,362,215,342,7094,7319,7787
E02001270,Sale North,379,181,477,501,674,823,828,670,597,542,464,361,338,261,447,6983,7164,7543
E02001271,Ashton upon Mersey North,406,161,478,368,453,534,538,476,503,514,442,347,325,211,311,5500,5661,6067
E02001272,Sale East,391,178,421,373,573,654,740,645,587,542,468,391,432,322,455,6603,6781,7172
E02001273,Sale Central,462,183,446,539,801,984,1009,817,694,593,487,422,421,322,525,8060,8243,8705
E02001274,Ashton upon Mersey South,499,205,591,354,367,547,597,626,623,633,562,506,503,436,631,6976,7181,7680
E02001275,Partington,574,264,743,596,687,675,559,465,572,628,548,399,359,224,331,6786,7050,7624
E02001276,Sale Moor,497,206,611,482,578,772,739,625,575,565,416,390,406,245,338,6742,6948,7445
E02001277,Broadheath & Firsway,662,255,699,623,690,861,807,798,788,637,475,352,300,253,212,7495,7750,8412
E02001278,West Timperley,534,218,551,426,496,715,761,746,668,581,502,426,428,301,398,6999,7217,7751
E02001279,Timperley North,485,228,501,373,482,632,744,705,668,633,499,435,465,317,411,6865,7093,7578
E02001280,Timperley East,570,254,654,484,508,563,609,651,605,611,493,406,440,362,475,6861,7115,7685
E02001281,Timperley South,437,200,545,341,374,526,609,623,614,576,458,411,457,380,582,6496,6696,7133
E02001282,Altrincham East,597,239,550,717,918,993,1017,834,699,613,470,388,371,270,342,8182,8421,9018
E02001283,"Altrincham West, Dunham & Warburton",514,243,615,549,712,799,812,759,678,734,589,449,463,425,621,8205,8448,8962
E02001284,Hale,508,260,551,382,466,615,704,690,749,634,547,369,358,270,342,6677,6937,7445
E02001285,Bowdon,491,228,545,394,387,452,583,575,690,632,577,479,459,406,595,6774,7002,7493
E02001286,Hale Barns,564,258,621,383,446,522,592,615,671,589,493,496,487,420,676,7011,7269,7833
E02001287,Standish North,285,145,550,558,488,468,437,434,521,516,421,314,356,284,292,5639,5784,6069
E02001288,Standish South,351,170,573,544,548,545,506,534,660,659,587,498,532,385,488,7059,7229,7580
E02001289,Shevington,454,200,656,507,604,573,592,711,794,799,703,695,746,565,651,8596,8796,9250
E02001290,Aspull & Red Rock,295,136,460,293,365,348,367,415,537,521,412,357,362,304,401,5142,5278,5573
E02001291,Beech Hill,387,187,614,516,581,559,426,479,588,581,505,394,388,312,328,6271,6458,6845
E02001292,Wigan Marylebone & Bottling Wood,322,138,538,502,668,618,497,557,636,643,589,473,453,380,528,7082,7220,7542
E02001293,New Springs,279,139,458,347,405,439,386,361,484,526,447,323,414,320,314,5224,5363,5642
E02001294,Wigan Central,305,181,690,653,769,664,581,562,618,618,544,324,352,220,391,6986,7167,7472
E02001295,Wigan East,339,157,572,547,604,597,474,488,627,608,494,389,328,213,279,6220,6377,6716
E02001296,Laithwaite & Marsh Green,604,253,753,684,804,736,594,555,609,538,418,339,318,214,248,6810,7063,7667
E02001297,Pemberton North,324,145,506,434,487,446,438,465,511,449,421,380,383,233,253,5406,5551,5875
E02001298,Ince-in-Makerfield,502,226,759,608,742,645,568,564,622,503,454,331,345,248,235,6624,6850,7352
E02001299,Hindley West,416,194,704,640,617,562,567,663,790,680,546,409,421,360,397,7356,7550,7966
E02001300,Pemberton South,386,174,592,579,577,603,529,510,635,568,449,427,461,369,416,6715,6889,7275
E02001301,Wigan South,454,178,703,660,882,749,554,574,654,570,449,395,408,264,374,7236,7414,7868
E02001302,Hindley East,441,206,685,491,549,506,496,481,635,619,473,394,463,369,406,6567,6773,7214
E02001303,Atherton North,507,214,752,674,760,716,636,576,654,592,483,378,367,241,256,7085,7299,7806
E02001304,Orrell & Longshaw,610,320,811,664,732,798,801,903,1046,986,804,658,800,631,842,10476,10796,11406
E02001305,Hindley Green,363,192,561,514,542,511,495,538,669,572,545,517,561,465,426,6916,7108,7471
E02001306,Worsley Mesnes & Hawkley,325,163,503,425,452,402,407,474,637,560,514,457,568,412,337,6148,6311,6636
E02001307,Winstanley,543,273,850,614,703,770,867,812,954,823,705,660,804,530,423,9515,9788,10331
E02001308,Atherton South East & Tyldesley West,254,124,392,356,432,382,356,369,483,457,393,370,353,309,339,4991,5115,5369
E02001309,Atherton South West,336,187,568,563,627,641,522,529,617,539,553,424,424,336,417,6760,6947,7283
E02001310,Platt Bridge & Spring View,500,209,763,688,725,758,640,646,699,595,445,415,419,291,278,7362,7571,8071
E02001311,Tyldesley North,371,153,603,539,621,617,508,514,637,647,547,486,476,307,320,6822,6975,7346
E02001312,Abram & Bickershaw,435,186,896,649,735,747,601,518,640,511,431,392,388,274,207,6989,7175,7610
E02001313,Leigh North,470,229,653,547,602,647,522,522,584,582,452,396,393,291,302,6493,6722,7192
E02001314,Tyldesley South,458,200,589,414,556,622,555,517,624,644,585,458,436,251,234,6485,6685,7143
E02001315,"Astley, Blackmoor & Mosley Common",395,179,549,632,846,761,609,581,691,613,571,439,503,409,388,7592,7771,8166
E02001316,Leigh Central,344,158,635,664,719,671,530,498,530,485,382,276,254,203,189,6036,6194,6538
E02001317,Leigh East & Higher Folds,423,210,686,573,699,543,553,625,742,695,552,449,481,395,411,7404,7614,8037
E02001318,Ashton-in-Makerfield North,391,192,608,472,517,462,490,522,614,569,504,459,529,393,429,6568,6760,7151
E02001319,Leigh West,372,185,644,682,736,652,475,493,621,627,478,395,399,283,290,6775,6960,7332
E02001320,Leigh South East,336,141,534,507,561,513,421,470,628,568,510,366,404,363,358,6203,6344,6680
E02001321,Ashton-in-Makerfield East,434,222,634,457,543,494,531,565,685,615,501,456,489,369,397,6736,6958,7392
E02001322,Ashton-in-Makerfield West,307,143,528,411,452,434,407,419,579,582,485,452,485,436,488,6158,6301,6608
E02001323,Leigh South,376,170,535,443,489,554,464,557,644,571,485,410,460,384,395,6391,6561,6937
E02001324,Golborne,445,229,628,510,647,546,561,545,619,616,482,410,447,297,378,6686,6915,7360
E02001325,Lowton,399,201,638,582,584,566,506,595,791,709,581,517,546,426,378,7419,7620,8019
E02001326,Lowton Common,394,175,560,494,479,486,460,558,638,630,518,430,513,441,413,6620,6795,7189
E02001327,Kirkby North East,655,279,859,784,904,888,695,615,535,547,550,553,381,166,131,7608,7887,8542
E02001328,Kirkby North West,497,247,838,712,841,799,772,749,803,818,718,611,544,334,394,8933,9180,9677
E02001329,Kirkby South East,385,184,657,624,659,600,531,532,557,586,607,521,295,144,218,6531,6715,7100
E02001330,Kirkby South West & Field Lane,456,248,857,700,810,702,587,597,703,686,692,602,399,200,293,7828,8076,8532
E02001331,Knowsley Village & Southdene,556,270,898,817,876,801,686,635,752,775,798,644,514,295,385,8876,9146,9702
E02001332,Stockbridge Village,399,171,682,560,644,602,473,469,639,706,484,286,273,281,367,6466,6637,7036
E02001333,Prescot,432,181,779,788,850,729,598,601,675,702,566,469,366,293,395,7811,7992,8424
E02001334,Page Moss & Fincham,384,163,612,650,681,577,482,377,480,500,434,284,229,152,175,5633,5796,6180
E02001335,Whiston North,396,187,648,634,690,560,448,551,689,740,546,399,394,219,341,6859,7046,7442
E02001336,Longview & Knowsley Park,382,167,650,619,697,610,405,409,526,613,478,308,277,165,263,6020,6187,6569
E02001337,Mosscroft & Bakers Green,307,151,510,436,477,404,348,371,502,518,430,296,237,151,318,4998,5149,5456
E02001338,Huyton Farm,307,141,467,504,594,483,369,317,453,500,434,278,258,208,302,5167,5308,5615
E02001339,Whiston South,351,186,567,427,478,434,391,419,541,462,448,289,275,225,272,5228,5414,5765
E02001340,Court Hey & Swanside,427,204,657,616,816,774,600,573,644,814,709,564,472,314,544,8097,8301,8728
E02001341,Huyton East,392,198,642,581,625,582,474,461,503,664,516,423,340,225,319,6355,6553,6945
E02001342,Huyton West & Roby,298,140,545,546,636,535,402,417,551,719,648,503,429,332,621,6884,7024,7322
E02001343,"Halsnead, Cronton & Halewood East",333,165,520,424,489,438,416,451,599,663,604,499,429,294,340,6166,6331,6664
E02001344,Halewood North,224,117,461,423,418,407,326,303,422,507,510,331,302,150,278,4838,4955,5179
E02001345,Halewood Central,198,133,403,358,400,354,290,336,410,474,460,396,338,216,301,4736,4869,5067
E02001346,Halewood South,437,196,691,562,639,658,589,472,499,664,566,416,321,177,301,6555,6751,7188
E02001347,Fazakerley North,415,219,684,583,663,599,521,533,666,636,561,412,314,215,319,6706,6925,7340
E02001348,Walton Vale,320,145,557,497,600,558,453,480,516,502,510,399,292,248,269,5881,6026,6346
E02001349,Orrell Park,361,170,789,766,825,723,632,607,632,714,570,449,382,243,312,7644,7814,8175
E02001350,Croxteth West & Gillmoss,521,203,678,551,645,683,594,529,561,642,605,485,391,254,421,7039,7242,7763
E02001351,Fazakerley South,484,210,1057,1007,1117,1005,795,696,701,713,632,470,343,212,265,9013,9223,9707
E02001352,Walton North,334,191,645,554,589,531,501,480,491,500,428,329,289,190,205,5732,5923,6257
E02001353,Croxteth East,346,197,638,480,525,455,447,457,578,721,623,447,317,186,243,6117,6314,6660
E02001354,Walton East,432,195,678,574,675,673,541,498,525,553,558,419,352,204,270,6520,6715,7147
E02001355,Walton Hall,350,160,631,557,583,534,455,458,490,556,467,355,305,215,237,5843,6003,6353
E02001356,Norris Green East,567,218,737,743,985,895,704,562,506,474,408,270,228,163,165,6840,7058,7625
E02001357,Norris Green West,472,191,652,508,633,593,514,440,479,563,477,380,266,200,323,6028,6219,6691
E02001358,Walton South,345,157,728,719,677,616,518,488,560,507,423,299,274,172,220,6201,6358,6703
E02001359,Croxteth Park,266,125,433,382,403,392,330,348,448,492,457,417,327,212,269,4910,5035,5301
E02001360,Kirkdale North,443,210,804,802,970,813,700,657,631,647,564,483,448,268,271,8058,8268,8711
E02001361,Anfield North,351,192,644,556,644,587,485,467,556,632,575,463,364,260,301,6534,6726,7077
E02001362,Muirhead Avenue,377,177,615,521,601,567,446,408,552,640,630,470,395,262,467,6574,6751,7128
E02001363,Yewtree,423,184,660,628,707,645,561,512,549,594,480,379,273,223,284,6495,6679,7102
E02001364,Anfield West,299,138,546,561,575,551,455,429,427,379,367,283,233,137,227,5170,5308,5607
E02001365,Anfield East,562,234,1085,1041,1060,907,766,682,736,594,525,384,280,206,296,8562,8796,9358
E02001366,Tuebrook,417,217,839,771,841,823,672,635,676,697,645,448,353,255,334,7989,8206,8623
E02001367,Sandfield Park & Holly Lodge,435,227,702,518,645,644,647,618,723,763,720,575,561,404,569,8089,8316,8751
E02001368,Kirkdale South & Vauxhall,339,156,687,669,733,719,533,502,501,502,507,456,360,254,280,6703,6859,7198
E02001369,Everton West,341,165,1065,892,880,807,567,515,595,533,509,451,427,260,279,7780,7945,8286
E02001370,Everton East,412,189,748,710,738,683,556,531,552,524,428,369,347,252,271,6709,6898,7310
E02001371,Knotty Ash,455,202,685,566,685,597,522,517,545,543,494,325,260,207,320,6266,6468,6923
E02001372,Dovecot,272,121,439,404,448,422,418,413,468,494,509,391,333,208,415,5362,5483,5755
E02001373,Fairfield East,454,222,831,763,802,735,644,604,686,805,621,449,384,217,338,7879,8101,8555
E02001374,Fairfield West & Newsham Park,405,214,1225,1294,1166,1016,929,757,681,655,482,374,288,186,199,9252,9466,9871
E02001375,Stoneycroft,339,160,638,484,543,531,475,439,559,533,487,418,324,256,344,6031,6191,6530
E02001376,Kensington,504,220,2190,1421,1185,920,771,671,605,520,399,327,263,172,213,9657,9877,10381
E02001377,Edge Hill,422,186,7062,3740,1725,1173,880,598,475,471,381,304,251,184,252,17496,17682,18104
E02001378,Wavertree East,357,176,589,530,591,576,506,521,600,624,558,432,408,235,365,6535,6711,7068
E02001380,Broad Green,346,144,538,495,576,605,505,476,610,611,541,440,440,311,377,6525,6669,7015
E02001381,Wavertree West,546,286,1482,1119,1216,1038,838,574,627,553,485,379,281,190,201,8983,9269,9815
E02001382,Childwall East,339,148,544,411,494,517,513,500,512,591,567,421,374,272,373,6089,6237,6576
E02001383,"Chinatown, St James & Georgian Quarter",230,109,2835,1887,1062,810,594,488,572,489,364,258,235,124,174,9892,10001,10231
E02001384,Wavertree South,322,167,3720,1046,883,783,583,471,424,349,337,245,205,121,159,9326,9493,9815
E02001385,Toxteth Park,744,374,1426,979,1163,1048,938,804,614,482,368,253,187,149,225,8636,9010,9754
E02001386,Belle Vale,405,197,637,553,663,632,531,525,616,676,611,482,519,361,403,7209,7406,7811
E02001387,Childwall West & Wavertree Green,361,191,607,470,547,555,535,508,590,654,571,519,501,296,465,6818,7009,7370
E02001388,Wavertree Penny Lane,260,141,1827,669,818,759,628,481,469,420,354,283,243,175,267,7393,7534,7794
E02001389,Princes Park,199,92,738,1040,1026,789,610,532,464,402,350,262,219,101,108,6641,6733,6932
E02001390,Toxteth,543,202,1007,1051,1009,976,759,666,661,711,593,428,374,251,309,8795,8997,9540
E02001391,Netherley,342,166,520,428,502,447,350,375,518,503,355,291,307,226,276,5098,5264,5606
E02001392,Gateacre,277,106,342,272,418,413,381,352,435,504,470,433,415,345,533,5313,5419,5696
E02001393,Calderstones,342,160,1046,395,378,411,459,444,532,588,616,557,568,380,507,6881,7041,7383
E02001394,Mossley Hill West & Sefton Park,279,130,1089,897,932,806,670,599,629,587,552,441,427,304,418,8351,8481,8760
E02001395,Mossley Hill East,254,115,352,325,455,515,476,443,430,421,429,372,329,240,318,5105,5220,5474
E02001396,Dingle,278,129,583,872,981,786,628,504,481,502,493,380,348,245,240,7043,7172,7450
E02001397,Woolton,279,121,425,441,571,517,428,416,497,589,619,593,521,325,564,6506,6627,6906
E02001398,St Michael's & Otterspool,256,141,706,768,774,713,661,501,526,534,484,406,395,267,353,7088,7229,7485
E02001399,West Allerton,306,145,450,389,488,601,503,457,475,572,554,465,412,292,437,6095,6240,6546
E02001400,Allerton,290,146,485,444,595,563,462,449,513,633,563,418,342,252,339,6058,6204,6494
E02001401,Hunts Cross,298,161,484,580,715,648,489,417,531,594,603,481,465,332,538,6877,7038,7336
E02001402,Aigburth & Grassendale,431,192,583,478,570,744,709,659,674,666,597,600,526,382,494,7682,7874,8305
E02001403,Garston,288,127,506,556,708,616,495,402,468,459,380,282,240,146,183,5441,5568,5856
E02001404,Speke West & Airport,458,255,627,645,782,731,554,514,563,602,529,364,257,179,226,6573,6828,7286
E02001405,Speke East,606,261,835,824,1017,956,712,584,604,713,632,526,384,203,283,8273,8534,9140
E02006932,Central & Islington,74,60,11217,4099,1782,926,545,319,189,193,115,95,79,47,37,19643,19703,19777
E02006933,Albert Dock & Queen's Dock,161,82,1606,1881,1326,804,503,347,351,353,292,237,208,116,84,8108,8190,8351
E02006934,Pier Head,60,46,1865,1590,1134,715,439,279,225,212,168,105,83,37,32,6884,6930,6990
E02001406,Rainford,340,157,468,323,409,416,386,489,639,640,618,517,664,616,650,6835,6992,7332
E02001407,Billinge,233,117,368,250,288,278,277,404,430,450,404,486,549,407,500,5091,5208,5441
E02001408,Garswood,235,106,356,336,312,294,318,351,444,411,414,394,454,342,313,4739,4845,5080
E02001409,Moss Bank,460,230,659,630,746,692,570,668,815,788,712,628,707,428,456,8499,8729,9189
E02001410,Haydock East,293,130,386,358,407,367,394,368,426,440,371,326,341,267,280,4731,4861,5154
E02001411,Haydock West,253,124,422,361,359,380,323,384,458,455,378,300,344,282,400,4846,4970,5223
E02001412,Windle & Denton's Green,472,240,675,524,637,636,558,606,656,720,606,487,534,317,480,7436,7676,8148
E02001413,Blackbrook,435,211,705,588,571,579,563,635,732,692,634,644,742,495,395,7975,8186,8621
E02001414,Eccleston,251,101,355,231,319,331,322,339,381,406,413,351,410,297,501,4656,4757,5008
E02001415,Earlestown North,412,197,533,476,502,538,484,505,548,480,400,311,286,221,237,5521,5718,6130
E02001416,Broad Oak,364,144,555,488,541,501,410,397,441,435,377,333,295,147,222,5142,5286,5650
E02001417,Town Centre West,282,155,577,600,622,565,514,562,618,586,469,358,286,203,274,6234,6389,6671
E02001418,Earlestown South,288,135,431,602,628,474,438,403,441,444,376,272,249,193,259,5210,5345,5633
E02001419,Town Centre East & Fingerpost,333,166,737,740,796,662,511,506,538,515,428,350,308,224,287,6602,6768,7101
E02001420,Newton-le-Willows,582,237,809,836,1037,960,796,728,803,888,684,528,480,339,515,9403,9640,10222
E02001421,West Park,449,192,885,747,805,739,638,694,917,858,774,573,493,397,440,8960,9152,9601
E02001422,Derbyshire Hill,396,166,588,498,560,557,436,444,485,432,419,308,232,151,222,5332,5498,5894
E02001423,Eccleston Park,267,146,490,355,385,393,378,411,541,598,472,431,444,352,409,5659,5805,6072
E02001424,Thatto Heath & Lea Green,828,395,1164,1070,1154,1152,1040,1095,1103,1026,867,628,691,500,678,12168,12563,13391
E02001425,Sutton Leach,434,209,813,719,772,697,699,673,858,822,705,701,671,476,558,9164,9373,9807
E02001426,Rainhill North,221,126,369,324,356,377,313,315,427,487,380,297,330,310,460,4745,4871,5092
E02001427,Bold & Clock Face,579,257,947,723,816,734,748,770,892,747,622,531,568,397,342,8837,9094,9673
E02001428,Rainhill South,231,131,365,291,301,327,317,372,437,451,391,336,403,388,559,4938,5069,5300
E02001429,Crossens,258,117,387,322,410,406,391,369,442,531,516,508,564,444,591,5881,5998,6256
E02001430,Marshside,286,171,494,331,391,376,337,439,517,603,585,511,546,411,618,6159,6330,6616
E02001431,Hesketh Park,216,99,359,308,328,344,331,408,465,608,629,615,708,636,1088,6827,6926,7142
E02001432,Southport Waterfront,252,117,657,748,764,775,658,645,729,739,687,568,527,415,729,8641,8758,9010
E02001433,Southport High Park,405,178,548,440,596,563,460,507,579,574,530,350,328,222,279,5976,6154,6559
E02001434,Meols Cop,404,183,582,434,497,576,455,509,594,592,550,381,342,239,245,5996,6179,6583
E02001435,Southport South,384,196,612,543,657,655,631,567,665,656,581,420,404,265,352,7008,7204,7588
E02001436,Southport Kew,488,257,716,604,756,693,586,602,736,761,663,551,515,357,475,8015,8272,8760
E02001437,Birkdale,345,176,576,369,380,410,427,542,664,828,797,695,845,691,1260,8484,8660,9005
E02001438,Hillside,361,183,546,395,475,428,423,474,639,595,513,443,407,293,334,5965,6148,6509
E02001439,Ainsdale East,359,175,528,382,412,402,390,375,509,554,477,422,391,299,421,5562,5737,6096
E02001440,Ainsdale West,215,99,347,246,257,270,280,314,431,481,498,527,600,554,665,5470,5569,5784
E02001441,Formby West & Freshfield North,308,151,431,267,275,304,317,426,459,519,497,492,563,502,649,5701,5852,6160
E02001442,Formby Central & Freshfield South,298,135,375,255,262,261,385,394,466,440,408,387,461,446,704,5244,5379,5677
E02001443,Formby South West,303,153,397,259,240,298,352,372,417,479,396,373,438,361,552,4934,5087,5390
E02001444,Formby South East & Ince Blundell,257,143,393,283,351,317,340,352,473,463,379,347,358,338,481,4875,5018,5275
E02001445,Maghull North West & Lydiate,265,143,459,311,419,417,429,438,475,569,540,487,517,378,591,6030,6173,6438
E02001446,Maghull North East,275,138,475,405,471,512,401,382,499,573,502,415,452,389,577,6053,6191,6466
E02001447,Maghull South East,223,124,388,346,349,367,328,296,422,461,460,399,416,345,580,5157,5281,5504
E02001448,Maghull South West,287,152,485,381,410,383,375,411,523,575,519,454,420,309,533,5778,5930,6217
E02001449,Hightown & Thornton,411,195,604,449,627,626,531,551,633,853,848,730,624,460,620,8156,8351,8762
E02001450,Blundellsands,380,184,496,387,431,467,555,502,644,698,675,628,665,458,671,7277,7461,7841
E02001451,Netherton North,298,147,458,393,465,461,334,327,429,475,453,315,315,194,365,4984,5131,5429
E02001452,Ford,279,126,492,478,506,448,396,379,482,474,462,340,290,184,288,5219,5345,5624
E02001453,Crosby East,386,199,586,499,588,580,557,519,642,739,636,602,514,392,541,7395,7594,7980
E02001454,Aintree East & Waddicar,323,158,530,426,463,497,454,464,550,566,561,445,385,298,495,6134,6292,6615
E02001455,Aintree West & Old Roan,289,130,530,470,566,469,395,382,493,672,621,436,355,262,428,6079,6209,6498
E02001456,Brighton le Sands & Crosby West,312,156,502,395,481,524,493,476,553,629,566,540,381,304,425,6269,6425,6737
E02001457,Netherton South,333,147,561,474,586,521,418,384,492,518,512,370,264,162,261,5523,5670,6003
E02001458,Waterloo,327,178,575,492,629,611,540,530,670,675,537,420,348,227,282,6536,6714,7041
E02001459,Litherland North,372,196,555,479,553,484,447,501,536,557,491,389,310,201,293,5796,5992,6364
E02001460,Seaforth North,316,116,546,512,600,551,484,511,606,608,602,438,414,276,434,6582,6698,7014
E02001461,Litherland South,330,158,526,482,578,510,390,421,500,579,480,374,380,254,302,5776,5934,6264
E02001462,Seaforth South,381,147,645,619,756,622,503,538,573,550,507,349,307,184,194,6347,6494,6875
E02001463,Orrell,409,193,638,517,623,591,509,513,529,576,464,312,305,196,296,6069,6262,6671
E02001464,Bootle North,374,167,643,615,633,538,487,491,542,520,423,324,276,197,197,5886,6053,6427
E02001465,Bootle South,341,157,623,656,724,662,585,487,576,563,457,400,338,195,254,6520,6677,7018
E02001466,Bootle East,469,196,842,682,780,721,641,560,653,667,542,485,381,289,354,7597,7793,8262
E02001467,New Brighton,281,123,454,452,501,471,478,470,606,689,626,553,476,391,511,6678,6801,7082
E02001468,Wallasey East,364,193,619,485,551,483,460,563,618,640,573,452,384,277,390,6495,6688,7052
E02001469,Wallasey Village,343,169,493,404,465,517,440,472,588,670,619,564,496,387,516,6631,6800,7143
E02001470,Wallasey Central,410,209,586,488,578,619,556,527,618,677,673,587,496,357,429,7191,7400,7810
E02001471,Egremont,443,199,678,491,591,595,529,472,590,528,468,355,367,230,301,6195,6394,6837
E02001472,Leasowe,421,171,550,456,507,523,429,430,559,629,521,409,349,214,303,5879,6050,6471
E02001473,Liscard,367,173,572,511,634,560,483,461,557,559,495,439,411,313,406,6401,6574,6941
E02001474,Seacombe,439,189,676,667,661,573,429,423,522,482,393,317,263,188,201,5795,5984,6423
E02001475,Leasowe South & Moreton East,412,181,509,437,490,470,392,408,447,437,404,302,313,214,281,5104,5285,5697
E02001476,Poulton,452,192,677,704,732,674,579,501,532,555,478,337,296,178,252,6495,6687,7139
E02001477,Bidston Hill,503,227,792,646,705,595,509,545,531,479,419,327,251,179,206,6184,6411,6914
E02001478,Moreton West,386,212,558,514,548,525,476,491,579,607,570,549,611,374,514,6916,7128,7514
E02001479,Great Meols,264,150,421,294,354,371,412,408,476,556,541,466,431,269,324,5323,5473,5737
E02001480,Hoylake,357,166,481,422,385,453,445,520,612,687,603,498,503,372,731,6712,6878,7235
E02001481,Claughton North,410,181,654,475,557,539,573,595,699,660,620,496,504,367,453,7192,7373,7783
E02001482,Birkenhead Central,357,198,815,715,760,654,614,602,665,654,525,435,299,209,234,7181,7379,7736
E02001483,Saughall Massie,290,146,441,382,474,409,429,433,502,618,591,566,524,351,418,6138,6284,6574
E02001484,Upton West,398,174,518,478,519,464,499,525,555,586,564,531,570,395,617,6821,6995,7393
E02001485,Noctorum North & Upton East,464,220,620,501,550,500,410,456,484,466,408,320,312,215,299,5541,5761,6225
E02001486,Claughton South & Oxton North,225,139,469,431,446,435,441,529,645,659,605,596,611,415,690,6972,7111,7336
E02001487,Birkenhead South,563,240,846,785,910,796,659,624,647,636,553,404,297,241,185,7583,7823,8386
E02001488,Oxton South,422,212,589,552,637,600,525,557,652,679,562,384,389,273,339,6738,6950,7372
E02001489,Greasby,315,169,439,318,447,442,433,475,562,630,635,627,727,485,664,6884,7053,7368
E02001490,Noctorum South,431,219,580,478,572,554,521,587,641,612,610,472,575,421,410,7033,7252,7683
E02001491,Woodchurch,394,171,543,518,551,519,423,441,470,479,445,397,376,194,290,5646,5817,6211
E02001492,West Kirby,385,192,501,334,361,453,482,520,569,625,567,494,535,385,656,6482,6674,7059
E02001493,Tranmere,499,221,808,710,817,669,626,607,593,557,485,407,345,224,270,7118,7339,7838
E02001494,Caldy & Newton,372,175,441,286,309,335,389,469,550,617,558,535,622,432,548,6091,6266,6638
E02001495,Egerton Park,457,202,630,479,578,552,499,532,650,624,493,434,388,277,405,6541,6743,7200
E02001496,Prenton,321,139,448,352,378,392,349,407,473,488,390,377,361,278,377,5070,5209,5530
E02001497,Bebington New Ferry,444,204,651,599,692,615,536,540,629,547,501,431,384,240,338,6703,6907,7351
E02001498,Woodhey,362,177,511,428,522,467,486,504,560,559,511,397,407,314,371,6037,6214,6576
E02001499,Thursaston & Irby,272,136,394,331,320,367,384,379,460,535,524,494,538,379,594,5699,5835,6107
E02001500,Pensby & Thingwall,305,145,466,353,485,463,427,463,547,578,570,500,546,418,574,6390,6535,6840
E02001501,Higher Bebington,347,214,553,419,529,519,495,502,619,642,558,445,469,378,437,6565,6779,7126
E02001502,Lower Bebington & Bromborough Pool,408,209,634,665,747,700,651,615,665,692,634,505,477,389,547,7921,8130,8538
E02001503,Heswall,310,172,441,353,387,399,397,486,516,609,562,515,562,483,732,6442,6614,6924
E02001504,"Poulton, Raby Mere & Thornton Hough",242,131,413,290,311,378,425,414,469,551,535,549,654,535,691,6215,6346,6588
E02001505,Bromborough North,280,149,487,381,458,476,396,425,515,477,416,377,360,295,407,5470,5619,5899
E02001506,Gayton & Lower Heswall,396,219,533,355,334,384,464,507,653,791,737,668,781,606,914,7727,7946,8342
E02001507,Bromborough South,320,138,425,347,387,386,416,430,514,545,470,481,544,475,574,5994,6132,6452
E02001508,Eastham,450,195,570,479,568,593,490,532,645,658,569,436,443,302,450,6735,6930,7380
E02003314,Hoo Peninsula,316,140,462,424,430,396,440,375,487,593,532,506,486,351,362,5844,5984,6300
E02003315,Cliffe,258,161,432,319,342,409,394,371,456,439,383,334,399,247,234,4759,4920,5178
E02003316,Hoo St Werburgh & High Halstow,647,304,927,746,853,866,810,817,816,832,693,547,603,462,425,9397,9701,10348
E02003317,Wainscott & City Estate,362,173,488,389,464,523,500,455,532,491,450,343,336,264,357,5592,5765,6127
E02003318,Broomhill,264,120,439,353,378,359,382,367,451,488,382,359,367,254,330,4909,5029,5293
E02003319,Strood North & Frindsbury,427,198,614,598,738,715,669,621,561,568,460,340,266,189,268,6607,6805,7232
E02003320,Chatham Maritime,474,210,1197,921,873,749,671,675,678,597,444,333,281,213,202,7834,8044,8518
E02003321,Rede Common,377,188,555,412,544,539,443,419,439,433,347,290,288,229,273,5211,5399,5776
E02003322,Gillingham North,337,165,1036,845,870,700,529,452,464,451,373,239,204,115,166,6444,6609,6946
E02003323,Gillingham North East,486,209,671,564,576,562,576,486,539,541,392,285,235,164,228,5819,6028,6514
E02003324,Strood South & Temple Marsh,624,275,810,744,953,890,757,660,680,606,511,383,354,211,241,7800,8075,8699
E02003325,Gillingham Central,406,203,729,679,887,786,591,542,503,475,397,279,207,138,138,6351,6554,6960
E02003326,Gillingham East,468,199,704,513,668,646,549,548,595,601,449,313,305,223,241,6355,6554,7022
E02003327,Rochester West,304,159,618,588,608,554,513,520,579,510,388,308,319,252,281,6038,6197,6501
E02003328,Chatham Central and Rochester Riverside,505,343,1080,1011,1131,977,801,715,607,579,439,320,234,167,223,8284,8627,9132
E02003329,Gillingham South,458,200,608,556,733,647,557,531,463,456,346,240,237,125,154,5653,5853,6311
E02003330,Rochester East,397,183,515,457,583,575,503,543,499,454,366,314,253,186,210,5458,5641,6038
E02003331,Twydall,473,238,700,602,596,627,575,503,642,680,592,491,435,337,441,7221,7459,7932
E02003332,Gillingham South East,339,151,500,392,438,420,404,387,483,486,452,360,303,232,346,5203,5354,5693
E02003333,Luton,496,190,657,583,699,693,555,502,543,443,351,233,189,128,179,5755,5945,6441
E02003334,Chatham South West,373,181,563,447,522,570,495,482,479,422,293,239,194,152,200,5058,5239,5612
E02003335,Chatham South East,582,249,760,585,633,675,613,495,493,432,327,196,167,123,110,5609,5858,6440
E02003336,Rainham North West,293,136,457,321,419,400,444,370,445,487,396,406,411,320,436,5312,5448,5741
E02003337,Rochester South West,425,271,743,591,667,559,530,497,597,539,439,309,314,219,349,6353,6624,7049
E02003338,Rainham North East,342,153,529,518,590,538,484,454,506,468,419,372,416,278,323,5895,6048,6390
E02003339,Rochester South East,376,174,485,368,410,466,445,417,455,518,422,334,318,284,399,5321,5495,5871
E02003340,Wayfield,488,222,591,508,565,599,524,562,571,594,520,419,359,261,358,6431,6653,7141
E02003341,Cuxton & Halling,309,166,449,398,474,471,435,464,537,545,410,346,395,287,291,5502,5668,5977
E02003342,Rainham South East,316,157,465,310,385,404,451,422,441,424,395,370,419,317,390,5193,5350,5666
E02003343,Rainham South West,301,156,450,287,245,303,383,395,493,465,457,403,499,378,453,5211,5367,5668
E02003344,Capstone,384,195,587,437,528,458,514,435,460,462,463,377,355,199,207,5482,5677,6061
E02003345,Parkwood East,334,145,442,363,455,476,450,414,418,409,395,336,349,204,188,4899,5044,5378
E02003346,Horsted,356,177,493,408,501,506,481,432,486,510,381,379,416,312,411,5716,5893,6249
E02003347,Settington,319,136,448,474,534,442,428,389,451,445,377,250,219,149,135,4741,4877,5196
E02003348,Hempstead & Wigmore,367,183,577,393,444,441,547,486,539,584,650,579,611,425,583,6859,7042,7409
E02003349,Parkwood West,336,163,503,441,521,454,500,476,464,451,435,424,516,397,413,5995,6158,6494
E02003350,Walderslade,379,171,488,382,486,457,445,434,491,453,410,344,351,272,327,5340,5511,5890
E02003351,Lordswood,417,202,513,501,604,559,573,470,504,551,483,412,415,350,284,6219,6421,6838
E02003352,Winkfield & Cranbourne,309,127,412,227,240,275,347,474,550,562,465,357,419,342,447,5117,5244,5553
E02003353,Binfield & Popeswood,555,280,811,889,1050,1053,974,887,911,847,709,590,466,327,413,9927,10207,10762
E02003354,Wick Hill,545,277,805,665,736,722,796,872,913,914,667,462,394,266,387,8599,8876,9421
E02003355,Priestwood,426,173,560,509,617,579,583,512,510,483,380,280,187,132,248,5580,5753,6179
E02003356,Chavey Down & North Ascot West,523,247,515,364,412,469,550,541,550,618,465,386,316,270,367,5823,6070,6593
E02003357,Bullbrook,507,216,735,807,1060,1099,968,771,719,608,528,352,330,217,413,8607,8823,9330
E02003358,Central Bracknell & Wildridings,654,282,1000,1026,1124,1161,1027,910,807,694,564,389,320,257,428,9707,9989,10643
E02003359,Crown Wood,258,123,370,503,677,599,531,492,479,465,451,288,202,127,120,5304,5427,5685
E02003360,Great Hollands,686,307,846,794,982,1038,1088,903,846,654,552,484,456,342,273,9258,9565,10251
E02003361,Birch Hill & Hanworth East,388,165,554,533,626,639,613,596,563,539,482,368,313,224,243,6293,6458,6846
E02003362,Hanworth West,339,144,459,401,554,640,577,473,460,431,403,348,351,208,213,5518,5662,6001
E02003363,Crowthorne South,822,564,572,318,334,376,433,485,496,441,361,330,358,318,548,5370,5934,6756
E02003364,Owlsmoor & Broadmoor,384,176,482,427,477,528,495,529,555,562,454,347,289,238,185,5568,5744,6128
E02003365,Sandhurst,385,182,466,336,395,512,514,527,578,503,425,407,392,287,317,5659,5841,6226
E02003366,College Town,256,159,1067,775,664,601,564,507,533,503,469,366,318,187,283,6837,6996,7252
E02003367,"Chieveley, East Isley & Compton",451,238,489,261,282,313,413,548,590,509,419,353,342,274,269,5062,5300,5751
E02003368,Lambourn & Great Shefford,257,125,441,363,393,398,370,425,514,505,402,357,381,311,320,5180,5305,5562
E02003369,Streatley & Pangbourne,347,185,468,268,364,375,444,523,554,574,477,373,373,278,396,5467,5652,5999
E02003370,Purley on Thames,332,169,476,335,364,436,445,535,589,555,468,406,424,338,388,5759,5928,6260
E02003371,Westwood,296,149,454,318,324,368,402,420,545,512,407,340,330,270,391,5081,5230,5526
E02003372,Calcot North & Little Heath,419,195,617,444,513,559,565,512,598,566,522,453,442,335,433,6559,6754,7173
E02003373,Hermitage & Cold Ash,809,395,579,346,368,441,578,608,742,678,522,404,435,310,381,6392,6787,7596
E02003374,Calcot South,266,125,427,377,477,436,414,382,445,442,426,345,291,187,197,4846,4971,5237
E02003375,Theale & Beenham,312,132,425,371,414,424,476,457,514,463,383,315,293,234,271,5040,5172,5484
E02003376,Hungerford,232,108,385,334,396,367,322,367,476,433,414,383,371,335,398,4981,5089,5321
E02003377,Thatcham South East & Bradfield,881,515,777,491,562,602,675,770,869,841,717,638,620,452,451,8465,8980,9861
E02003378,Newbury North West,348,137,511,489,536,581,585,604,594,569,532,436,475,393,557,6862,6999,7347
E02003379,Newbury Clay Hill,323,167,532,496,658,600,566,517,523,438,386,282,289,203,323,5813,5980,6303
E02003380,Thatcham West,382,171,615,577,687,592,557,550,643,615,563,471,410,270,238,6788,6959,7341
E02003381,Burghfield Common,379,170,406,288,302,345,464,506,515,450,342,324,311,197,280,4730,4900,5279
E02003382,Thatcham Town,391,186,614,529,525,526,528,523,637,560,428,352,376,301,411,6310,6496,6887
E02003383,Thatcham North East,419,175,515,382,430,544,547,565,565,552,476,334,315,197,214,5636,5811,6230
E02003384,Kintbury & Boxford,309,143,435,284,330,363,352,473,572,597,538,424,407,348,425,5548,5691,6000
E02003385,Newbury Central & Greenham,371,162,786,1073,1311,1282,938,754,747,645,499,439,392,317,459,9642,9804,10175
E02003386,Newbury South West,434,194,590,548,666,633,671,651,660,612,513,396,439,342,360,7081,7275,7709
E02003387,Newbury Wash Common,604,246,620,472,535,612,682,802,732,609,557,506,570,444,558,7699,7945,8549
E02003388,Mortimer & Aldermaston Wharf,317,202,401,283,328,364,401,493,527,481,385,322,350,288,325,4948,5150,5467
E02003389,Caversham Emmer Green,454,202,515,400,490,501,642,699,594,570,489,417,497,374,478,6666,6868,7322
E02003390,Caversham Heights,541,220,513,287,294,440,657,746,656,638,514,455,413,323,428,6364,6584,7125
E02003391,Caversham Balmore Park,562,241,524,431,560,712,843,770,676,590,482,365,413,337,526,7229,7470,8032
E02003392,Lower Caversham,415,164,624,829,1037,1027,895,673,591,492,385,295,260,220,276,7604,7768,8183
E02003393,Tilehurst North,399,187,557,460,565,567,588,572,613,666,560,414,402,337,456,6757,6944,7343
E02003394,Norcot North,543,248,762,636,852,890,756,610,583,506,449,336,287,200,297,7164,7412,7955
E02003395,Battle & Caversham Bridge,550,202,1071,1427,1715,1577,1314,986,822,667,474,299,201,148,182,10883,11085,11635
E02003396,Norcot South,479,224,809,948,1172,1140,1036,817,792,614,515,351,281,211,309,8995,9219,9698
E02003397,Tilehurst South,483,219,682,509,613,629,606,575,576,605,479,365,378,281,406,6704,6923,7406
E02003398,Palmer Park,535,221,1479,1408,1678,1457,1234,970,738,572,395,330,259,158,202,10880,11101,11636
E02003399,Reading Central,481,193,2311,2771,3168,2730,1898,1250,887,726,522,339,228,165,161,17156,17349,17830
E02003400,Wokingham Road,344,162,1908,917,901,829,711,584,496,402,312,240,226,162,299,7987,8149,8493
E02003401,Coley Park,424,198,634,815,990,1029,932,730,589,555,473,327,248,206,439,7967,8165,8589
E02003402,Southampton Street & Redlands Road,424,225,1887,1706,1828,1496,1207,874,710,527,391,280,268,180,179,11533,11758,12182
E02003403,Southcote,511,218,666,614,820,817,716,691,690,684,503,426,392,320,444,7783,8001,8512
E02003404,Leighton Park,439,245,3530,1423,815,669,571,489,451,417,312,253,204,173,259,9566,9811,10250
E02003405,Kennet Island & Green Park,811,367,1295,1288,1501,1636,1196,1008,900,790,590,390,311,236,231,11372,11739,12550
E02003406,Whitley Wood,487,222,735,655,740,738,621,584,651,551,468,410,318,202,268,6941,7163,7650
E02003407,Britwell,899,392,986,692,931,1085,1009,831,757,694,521,347,246,137,236,8472,8864,9763
E02003408,Manor Park,806,329,1059,894,1187,1309,1154,998,783,685,585,439,322,181,302,9898,10227,11033
E02003409,Haymill & Lynch Hill,618,294,783,690,878,950,943,760,786,682,573,403,312,217,294,8271,8565,9183
E02003410,Baylis & Stoke,942,400,1343,1074,1289,1397,1216,1038,832,660,610,475,291,197,301,10723,11123,12065
E02003411,Wexham Lea,829,331,1281,1069,1225,1293,1168,916,792,630,575,446,301,218,399,10313,10644,11473
E02003412,Cippenham Green,724,300,842,690,783,1022,928,863,745,584,503,406,352,208,277,8203,8503,9227
E02003413,Stoke Road & Wexham Road,891,377,1405,1493,1902,2003,1593,1205,940,728,602,522,367,213,342,13315,13692,14583
E02003414,Cippenham Meadows,920,384,1067,905,1214,1485,1390,1096,846,714,585,430,323,210,219,10484,10868,11788
E02003415,Chalvey,896,362,1284,1249,1649,1780,1420,1071,792,646,492,365,271,167,309,11495,11857,12753
E02003416,Langley St Mary's,641,242,718,627,767,926,973,731,628,567,465,373,270,200,291,7536,7778,8419
E02003417,Central Slough & Upton Court,668,276,944,1107,1411,1527,1338,996,804,685,503,456,342,224,316,10653,10929,11597
E02003418,Langley Kederminster,748,326,882,691,769,906,1122,925,746,603,520,397,311,168,277,8317,8643,9391
E02003419,Langley Foxborough,576,253,798,589,694,854,781,695,664,569,445,324,251,182,310,7156,7409,7985
E02003420,Colnbrook & Poyle,391,147,465,485,604,639,641,474,494,416,363,221,170,102,117,5191,5338,5729
E02003421,Pinkney's Green & Furze Platt Road,310,138,353,305,320,427,438,424,464,391,396,292,344,254,353,4761,4899,5209
E02003422,Cookham & Waltham,579,264,762,462,557,695,869,926,1004,1060,899,696,764,592,763,10049,10313,10892
E02003423,Furze Platt,435,160,564,399,460,568,579,527,483,409,367,287,251,204,232,5330,5490,5925
E02003424,Maidenhead East,370,164,466,594,720,781,815,703,654,668,613,523,485,443,636,8101,8265,8635
E02003425,Maidenhead Central,593,233,877,1049,1540,1635,1310,1026,866,749,545,464,393,355,517,11326,11559,12152
E02003426,Maidenhead Highway,625,267,690,492,551,616,725,873,916,756,613,449,448,360,588,8077,8344,8969
E02003427,Boyn Hill & Norreys Drive,489,204,647,579,705,833,814,670,591,498,408,305,272,187,303,6812,7016,7505
E02003428,Cox Green,497,222,622,426,591,683,794,670,697,644,535,519,506,347,396,7430,7652,8149
E02003429,Bray Wick & Holyport,443,214,561,370,455,494,622,638,647,603,520,452,475,361,444,6642,6856,7299
E02003430,Windsor Town & Eton,989,617,655,616,669,628,586,536,564,541,442,299,249,177,281,6243,6860,7849
E02003431,Datchet,358,154,503,419,537,561,586,525,573,525,456,330,350,245,313,5923,6077,6435
E02003432,Clewer Village,326,139,648,610,775,703,793,656,656,576,363,297,273,174,361,6885,7024,7350
E02003433,Dedworth,282,143,377,367,410,470,452,403,403,443,378,334,323,322,432,5114,5257,5539
E02003434,Clewer New Town,535,235,638,592,678,755,780,773,717,650,550,397,383,295,534,7742,7977,8512
E02003435,Spital & Cranbourne Park,413,210,484,438,480,533,598,687,719,620,395,340,321,303,305,6223,6433,6846
E02003436,Old Windsor & Wraysbury,459,200,600,446,486,511,622,731,740,753,646,532,534,403,605,7609,7809,8268
E02003437,Ascot & North Ascot East,552,246,640,380,387,382,534,648,721,659,558,386,400,330,391,6416,6662,7214
E02003438,South Ascot & Sunningdale,919,460,952,543,464,577,734,993,1040,938,781,565,611,529,817,9544,10004,10923
E02003439,Twyford East & Wargrave,282,124,386,320,348,374,434,506,517,474,413,283,371,332,424,5182,5306,5588
E02003440,Twyford West & Charvil,564,255,550,421,541,646,735,892,753,645,550,434,463,400,519,7549,7804,8368
E02003441,Sonning & Woodley North,429,206,546,400,420,455,536,593,656,606,573,437,426,359,570,6577,6783,7212
E02003442,Woodley East,410,210,613,568,643,724,739,591,653,663,497,363,324,223,270,6871,7081,7491
E02003443,Woodley South,367,167,499,383,483,557,564,506,469,455,353,283,319,269,507,5647,5814,6181
E02003444,Earley,578,260,826,616,661,823,942,782,707,665,569,426,350,293,480,8140,8400,8978
E02003445,Southlake,416,203,555,456,623,742,791,644,631,650,452,451,449,398,477,7319,7522,7938
E02003446,Lower Earley North,570,283,1994,708,550,569,784,780,652,616,584,416,483,340,406,8882,9165,9735
E02003447,Winnersh,669,287,851,645,767,896,978,954,801,710,535,388,409,311,421,8666,8953,9622
E02003448,Wokingham North & Hurst,461,207,557,391,501,602,730,662,642,537,459,381,414,301,370,6547,6754,7215
E02003449,Lower Earley South,447,187,519,484,585,701,756,685,595,516,486,320,234,154,181,6216,6403,6850
E02003450,Shinfield,736,308,912,878,1082,1241,1356,1121,875,751,701,514,458,290,477,10656,10964,11700
E02003451,Wokingham Town,453,195,611,657,744,746,798,778,661,610,465,454,462,412,744,8142,8337,8790
E02003452,Wokingham East,527,252,539,566,651,743,864,783,689,582,465,353,349,293,353,7230,7482,8009
E02003453,Barkham & Woose Hill,440,195,440,322,357,487,544,584,568,597,482,391,381,263,267,5683,5878,6318
E02003454,Wokingham West & South,462,223,546,456,514,680,723,729,637,587,501,426,434,358,537,7128,7351,7813
E02003455,Spencers Wood & Swallowfield,528,201,611,687,946,977,916,696,709,668,573,420,420,309,352,8284,8485,9013
E02003456,Arborfield & Garrison,571,272,570,523,604,694,670,679,614,483,394,308,318,228,308,6393,6665,7236
E02003457,Finchampstead,595,289,743,481,417,511,704,872,850,934,744,587,652,455,479,8429,8718,9313
E02003458,Crowthorne North,515,238,575,389,405,532,646,634,744,734,589,483,500,430,477,7138,7376,7891
E02003459,Olney & Lavendon,488,209,586,418,440,478,543,693,734,751,620,567,592,431,570,7423,7632,8120
E02003460,"Hanslope, Castlethorpe & Sherington",599,236,707,596,789,956,896,814,869,866,752,679,681,484,548,9637,9873,10472
E02003461,Newport Pagnell North,401,165,471,408,488,549,604,524,491,472,484,480,536,349,490,6346,6511,6912
E02003462,Newport Pagnell South,396,189,560,563,664,710,626,632,646,576,504,484,395,296,334,6990,7179,7575
E02003463,Great Linford & Giffard Park,351,166,509,482,524,585,536,521,525,470,524,446,466,271,289,6148,6314,6665
E02003464,Stantonbury & Bradville,461,218,647,498,631,641,583,527,494,481,401,328,279,171,146,5827,6045,6506
E02003465,Willen & Downhead Park,230,110,450,431,523,464,480,413,464,472,514,513,401,286,383,5794,5904,6134
E02003466,Wolverton & New Bradwell,433,195,619,627,803,776,672,584,516,449,337,287,254,144,182,6250,6445,6878
E02003467,Linford Wood,366,167,570,587,650,665,617,523,470,455,375,361,293,206,320,6092,6259,6625
E02003468,Stony Stratford & Old Wolverton,406,167,565,520,688,817,728,611,574,510,472,474,489,351,422,7221,7388,7794
E02003469,Bradwell Village,247,124,352,359,444,457,464,396,380,430,457,426,336,212,213,4926,5050,5297
E02003470,Stacey Bushes & Fullers Slade,512,238,654,475,541,519,550,496,441,330,308,235,178,126,84,4937,5175,5687
E02003471,Bradwell Common,379,194,624,577,681,656,603,515,468,433,419,406,289,170,180,6021,6215,6594
E02003472,Central Milton Keynes & Newlands,477,219,1114,1403,1683,1412,1051,851,695,601,400,240,183,84,105,9822,10041,10518
E02003473,Two Mile Ash,279,114,372,384,427,544,532,406,363,417,371,335,272,188,174,4785,4899,5178
E02003474,Woughton & Woolstone,594,282,737,579,707,796,849,816,691,574,518,400,366,201,195,7429,7711,8305
E02003475,"Broughton, Middleton & Kents Hill",1802,697,1863,1754,2482,3058,2933,2206,1599,1153,882,636,435,266,324,19591,20288,22090
E02003476,Eaglestone & Fishermead,593,276,824,747,925,847,848,725,660,546,413,323,268,145,184,7455,7731,8324
E02003477,Shenley Wood & Grange Farm,1086,508,1259,1388,1708,1973,1860,1422,1131,879,721,470,471,359,424,14065,14573,15659
E02003478,Loughton,379,169,474,403,521,580,584,575,539,575,452,359,279,182,221,5744,5913,6292
E02003479,Oldbrook & Coffee Hall,500,234,710,667,853,879,751,661,564,412,383,270,241,113,117,6621,6855,7355
E02003480,Walnut Tree & Tilbrook,436,208,703,584,708,648,713,664,777,678,502,343,248,150,155,6873,7081,7517
E02003481,Denbigh,517,249,733,626,800,747,684,661,571,527,396,337,234,176,181,6673,6922,7439
E02003482,Bow Brickhill & Woburn Sands,446,202,632,637,736,761,666,614,616,655,535,443,411,278,373,7357,7559,8005
E02003483,Westcroft & Shenley Brook End,895,407,1079,695,767,916,1182,1195,1139,823,505,322,234,115,145,9117,9524,10419
E02003484,Furzton,402,191,612,480,529,575,664,602,574,543,465,373,358,228,187,6190,6381,6783
E02003485,Bletchley North West,439,215,642,578,690,616,591,562,620,558,494,425,388,335,429,6928,7143,7582
E02003486,Tattenhoe & Emerson Valley,713,330,798,558,708,862,1007,1040,868,727,511,334,264,167,153,7997,8327,9040
E02003487,Far Bletchley,387,171,584,474,550,543,566,462,516,492,451,430,445,364,391,6268,6439,6826
E02003488,Bletchley East,425,197,764,654,820,722,632,560,609,497,469,419,386,313,357,7202,7399,7824
E02003489,Bletchley West,381,139,507,524,604,580,565,500,552,524,470,393,434,273,474,6400,6539,6920
E02003490,Bletchley South,770,353,934,848,1063,1053,907,725,632,510,375,302,307,211,220,8087,8440,9210
E02003491,Patcham East,469,217,692,457,556,561,609,600,709,642,483,363,386,252,397,6707,6924,7393
E02003492,Coldean & Moulsecoomb North,305,216,7803,2468,1832,1004,622,502,437,400,297,222,200,148,210,16145,16361,16666
E02003493,Patcham West & Westdene,419,212,595,424,463,511,665,571,698,654,496,426,439,367,689,6998,7210,7629
E02003494,Hollingbury,423,213,576,388,378,373,454,636,651,589,407,350,343,227,309,5681,5894,6317
E02003495,Mile Oak,371,150,569,459,538,543,517,511,608,573,393,333,339,263,312,5958,6108,6479
E02003496,Hangleton North,413,208,624,469,537,493,578,573,551,577,474,369,382,267,493,6387,6595,7008
E02003497,West Blatchington,479,225,581,404,443,498,563,691,678,693,550,409,399,328,448,6685,6910,7389
E02003498,Hollingdean & Moulsecoomb West,401,187,1672,788,755,652,615,603,594,544,432,330,250,188,273,7696,7883,8284
E02003499,Bevendean & Moulsecoomb East,376,211,1554,820,704,626,530,482,508,506,404,280,247,212,273,7146,7357,7733
E02003500,Fiveways,514,276,1047,617,566,617,693,745,866,739,477,341,275,151,158,7292,7568,8082
E02003501,Withdean Woods,497,203,659,619,683,711,698,788,827,662,472,381,362,228,326,7416,7619,8116
E02003502,Portslade Village,405,193,614,460,615,610,670,603,675,606,471,323,346,229,322,6544,6737,7142
E02003503,Hangleton South,545,244,845,554,592,686,706,741,781,692,571,434,407,271,422,7702,7946,8491
E02003504,Preston Park,353,185,1110,931,993,850,846,843,782,669,416,356,295,195,226,8512,8697,9050
E02003505,Round Hill,203,100,2266,1200,1033,883,676,615,618,432,324,225,179,84,110,8645,8745,8948
E02003506,Aldrington,370,180,473,471,607,738,818,801,641,473,346,255,195,125,156,6099,6279,6649
E02003507,Woodingdean,502,236,740,551,592,694,687,688,809,810,604,571,522,459,619,8346,8582,9084
E02003508,Elm Grove & Bear Road,301,144,1917,940,855,744,713,690,609,499,350,259,219,122,158,8075,8219,8520
E02003509,Goldsmid West,305,120,657,1075,1233,1071,998,857,762,604,422,317,304,243,299,8842,8962,9267
E02003510,Goldsmid East,359,181,769,973,1137,1020,944,899,765,666,495,359,340,275,441,9083,9264,9623
E02003511,Portslade by Sea,493,228,634,563,670,708,816,850,840,701,472,352,316,223,352,7497,7725,8218
E02003512,Hanover,271,137,1801,1012,987,862,750,670,699,531,355,276,206,108,115,8372,8509,8780
E02003513,Aldrington South,362,173,450,398,381,413,483,598,626,580,461,345,303,250,416,5704,5877,6239
E02003514,Seven Dials,189,112,920,1460,1523,1223,974,822,672,553,388,274,235,135,158,9337,9449,9638
E02003515,Whitehawk,596,262,1020,803,902,820,665,668,745,688,480,366,326,217,273,7973,8235,8831
E02003516,Hove Central,217,97,802,1236,1394,1011,970,864,721,633,430,312,253,184,243,9053,9150,9367
E02003517,North Laine & the Lanes,262,283,3292,2284,2009,1505,1069,871,803,693,475,340,269,190,205,14005,14288,14550
E02003518,King Alfred,248,287,524,736,851,830,756,763,702,654,458,403,341,298,468,7784,8071,8319
E02003519,Brunswick,153,90,1126,1620,1649,1321,1066,959,738,640,441,314,239,138,144,10395,10485,10638
E02003520,St James's Street & Queen's Park,247,115,1537,1482,1448,1215,945,815,765,691,536,385,301,183,230,10533,10648,10895
E02003521,Kemptown,422,268,861,960,914,680,658,649,735,640,491,364,368,268,388,7976,8244,8666
E02003522,Roedean & Marina,487,282,822,718,716,589,624,608,670,606,464,412,399,267,291,7186,7468,7955
E02003523,Rottingdean & Saltdean,398,185,596,507,556,549,639,727,844,943,786,745,758,645,873,9168,9353,9751
E02003524,Paulsgrove East,557,263,759,603,635,642,537,554,629,544,431,358,344,226,236,6498,6761,7318
E02003525,Wymering,390,176,554,612,661,564,463,378,437,441,383,253,254,156,176,5332,5508,5898
E02003526,Cosham North,333,136,433,290,338,374,407,432,471,500,448,458,474,390,675,5690,5826,6159
E02003527,Paulsgrove West & Port Solent,270,130,477,454,547,455,375,370,469,449,417,326,351,255,273,5218,5348,5618
E02003529,Cosham South,419,216,636,498,651,629,551,592,617,580,454,367,340,274,383,6572,6788,7207
E02003530,Hilsea,424,191,559,529,609,600,505,498,534,528,453,398,370,278,317,6178,6369,6793
E02003531,Anchorage Park & Copnor,342,182,602,498,559,544,478,517,654,687,556,419,406,302,379,6601,6783,7125
E02003532,Alexandra Park,392,200,655,597,702,702,665,542,578,580,491,384,293,221,225,6635,6835,7227
E02003533,North End West & Whale Island,276,116,713,773,884,869,730,674,602,463,357,230,209,171,193,6868,6984,7260
E02003534,North End East,456,214,766,730,812,749,660,626,682,641,506,380,343,238,241,7374,7588,8044
E02003535,Fratton North,513,229,846,926,973,876,714,675,732,625,519,338,269,188,231,7912,8141,8654
E02003536,Landport,500,209,920,888,865,841,634,561,515,547,427,333,318,214,238,7301,7510,8010
E02003537,Baffins,548,274,797,706,840,803,706,718,822,801,619,484,430,319,427,8472,8746,9294
E02003538,Fratton Kingston,485,201,1140,1125,1219,1119,854,723,664,647,485,337,290,190,258,9051,9252,9737
E02003539,Fratton West & Portsea,565,286,6935,3624,2478,1935,1378,1040,873,705,508,442,361,268,321,20868,21154,21719
E02003540,Milton,431,204,675,624,855,840,693,594,661,708,614,481,450,447,563,8205,8409,8840
E02003541,Somers Town,575,229,2533,1392,1002,907,690,568,540,468,404,329,302,240,364,9739,9968,10543
E02003542,Southsea Haslemere Road,325,149,1362,930,865,887,662,561,536,490,360,287,262,192,256,7650,7799,8124
E02003543,Southsea Fawcett Road,254,119,1661,1031,851,785,607,495,497,443,306,277,268,149,191,7561,7680,7934
E02003544,Southsea Prince Albert Road,284,121,504,570,657,645,511,455,491,497,337,221,188,127,187,5390,5511,5795
E02003545,Southsea West,195,118,990,879,760,694,553,434,447,479,369,330,291,213,335,6774,6892,7087
E02003546,Eastney,292,141,522,621,664,662,605,540,643,634,557,452,403,341,425,7069,7210,7502
E02003547,Old Portsmouth & Southsea Common,209,119,1383,1055,884,730,511,484,488,507,466,428,503,353,606,8398,8517,8726
E02003548,Southsea Waverley Road,199,121,713,652,607,563,527,436,488,474,387,271,231,199,328,5876,5997,6196
E02006821,Drayton & Farlington,377,159,462,323,416,475,398,429,518,443,407,299,332,271,413,5186,5345,5722
E02003549,Bassett Green,315,158,2978,1041,736,653,565,467,437,448,433,357,318,227,326,8986,9144,9459
E02003550,Aldermoor & Lordswood,451,183,632,586,652,619,644,608,539,492,460,477,460,314,266,6749,6932,7383
E02003551,Stoneham,244,131,2393,893,579,482,405,375,369,343,345,237,261,185,189,7056,7187,7431
E02003552,Coxford & Lords Hill,326,163,529,474,511,431,446,476,477,436,408,365,383,236,239,5411,5574,5900
E02003553,Swaythling,365,156,2497,1342,869,739,566,437,357,328,231,202,186,95,146,7995,8151,8516
E02003554,Hollybrook,226,110,530,503,565,518,489,405,376,381,341,328,341,255,406,5438,5548,5774
E02003555,Maybush,480,239,705,676,804,733,690,650,568,489,463,444,371,235,300,7128,7367,7847
E02003556,Townhill Park,322,124,388,327,391,453,408,431,400,463,330,256,263,237,305,4652,4776,5098
E02003557,Highfield & University,203,81,1662,770,635,574,516,370,312,302,307,247,277,224,341,6537,6618,6821
E02003558,Shirley Warren,441,183,558,671,836,745,712,585,495,417,343,249,257,184,274,6326,6509,6950
E02003559,Upper Shirley,429,198,547,537,580,681,684,599,547,541,497,430,398,268,380,6689,6887,7316
E02003560,Redbridge & Millbrook West,466,214,713,571,624,609,587,512,468,466,403,315,235,170,225,5898,6112,6578
E02003561,St Denys,229,122,1997,1090,807,776,596,489,414,413,342,256,219,181,280,7860,7982,8211
E02003562,Bitterne West,382,150,558,580,698,775,694,618,601,567,460,348,309,255,328,6791,6941,7323
E02003563,Shirley South,378,194,598,665,851,750,683,629,540,513,423,330,303,232,379,6896,7090,7468
E02003564,Bitterne East,419,177,549,535,656,603,547,571,499,566,456,359,353,287,432,6413,6590,7009
E02003565,Bevois Town,170,102,1748,1089,910,713,600,447,346,302,226,144,133,106,152,6916,7018,7188
E02003566,Harefield,340,148,463,423,473,508,409,378,394,447,436,370,329,251,348,5229,5377,5717
E02003567,Regents Park & Millbrook East,525,222,665,594,680,715,695,585,603,533,423,366,268,209,208,6544,6766,7291
E02003568,Banister Park & Howard Road,266,117,1109,1191,1105,1054,868,645,519,454,338,299,230,186,214,8212,8329,8595
E02003569,Freemantle,300,128,628,900,997,919,765,608,536,482,393,283,216,155,164,7046,7174,7474
E02003570,Newtown & Nicholstown,673,285,2989,2121,1788,1586,1359,1036,761,597,468,263,158,90,119,13335,13620,14293
E02003571,Central Southampton West,141,77,4248,2186,1219,759,568,415,291,228,212,174,145,128,267,10840,10917,11058
E02003572,Bitterne South,299,165,440,359,476,487,485,443,450,474,433,316,288,226,329,5206,5371,5670
E02003573,Thornhill,473,183,623,525,635,627,524,484,501,547,471,374,342,289,409,6351,6534,7007
E02003574,Sholing East,320,154,504,508,546,558,514,455,548,568,514,420,435,375,394,6339,6493,6813
E02003575,Hightown,387,176,537,480,598,516,458,369,407,454,365,258,223,202,216,5083,5259,5646
E02003576,Itchen,417,197,655,659,742,702,629,560,654,574,424,345,306,236,271,6757,6954,7371
E02003577,Central Southampton East,434,149,3586,2655,2292,1630,1201,860,668,569,461,349,257,178,160,14866,15015,15449
E02003578,Sholing West,297,128,483,461,505,512,395,415,459,521,383,329,292,231,267,5253,5381,5678
E02003579,Woolston,390,194,705,844,1025,837,746,589,607,604,555,399,356,259,426,7952,8146,8536
E02003580,Weston,356,148,479,486,552,510,452,400,401,370,329,272,232,174,163,4820,4968,5324
E02003581,Cowes Central,320,154,509,490,558,519,501,480,605,624,553,444,435,373,451,6542,6696,7016
E02003582,"Cowes West, Gurnard & Northwood",398,197,526,371,446,489,555,565,696,692,604,560,636,518,608,7266,7463,7861
E02003583,East Cowes & Osborne,376,157,488,375,455,427,400,432,546,552,490,543,616,532,438,6294,6451,6827
E02003584,Ryde Central,193,132,478,420,434,327,366,398,548,594,476,441,407,283,333,5505,5637,5830
E02003585,Binstead & Wootton,276,145,355,265,279,293,309,386,488,549,560,543,648,584,666,5925,6070,6346
E02003586,Ryde West & Havenstreet,402,188,543,407,427,445,472,528,596,636,585,534,554,450,555,6732,6920,7322
E02003587,Ryde South,440,197,655,550,596,552,538,566,677,653,589,491,510,393,424,7194,7391,7831
E02003588,Newport East & Parkhurst East,417,213,632,685,773,662,583,526,691,668,579,532,474,401,508,7714,7927,8344
E02003589,Newport Central & Parkhurst West,347,158,605,623,643,549,448,458,563,563,416,345,362,262,319,6156,6314,6661
E02003590,Bembridge & Nettlestone,271,131,336,222,210,288,309,351,493,604,615,717,789,685,918,6537,6668,6939
E02003591,Newport South & West,499,246,654,515,624,584,580,598,713,751,636,562,612,508,627,7964,8210,8709
E02003592,Yarmouth & Freshwater,286,164,517,419,435,344,371,469,669,756,850,942,1042,876,1118,8808,8972,9258
E02003593,Brighstone & Shalfleet,185,91,263,193,215,217,268,303,419,523,508,519,506,406,465,4805,4896,5081
E02003594,Sandown & Brading,398,186,645,517,491,508,496,552,685,817,753,746,688,564,692,8154,8340,8738
E02003595,Shanklin West & Newchurch,247,133,411,360,375,385,334,396,561,713,742,795,760,673,733,7238,7371,7618
E02003596,Shanklin Central & Lake,304,157,523,442,481,403,425,493,654,785,779,764,786,603,677,7815,7972,8276
E02003597,"Niton, Shorwell & Godshill",216,109,342,221,238,253,285,315,471,527,554,498,587,375,450,5116,5225,5441
E02003598,Ventnor & Wroxall,315,145,418,307,361,338,379,398,569,675,656,647,719,555,579,6601,6746,7061
E02003652,"Buckingham South, Maids Moreton & Akeley",917,596,1016,696,628,670,750,773,740,774,684,527,454,352,464,8528,9124,10041
E02003653,Buckingham North,328,158,1078,811,620,467,477,470,515,464,420,370,371,257,378,6698,6856,7184
E02003654,Newton Longville & Great Horwood,279,149,378,239,265,308,347,411,531,538,445,397,415,296,260,4830,4979,5258
E02003655,"Marsh Gibbon, Steeple Claydon & Tingewick",576,289,697,488,647,591,694,812,913,931,748,615,634,397,445,8612,8901,9477
E02003656,Winslow & Padbury,308,136,395,357,429,393,358,415,485,540,482,429,396,330,430,5439,5575,5883
E02003657,"Granborough, Stewkley & Great Brickhill",403,153,455,383,417,435,497,498,573,648,566,473,448,312,360,6065,6218,6621
E02003658,"Wing, Wingrave & Bierton",441,235,535,589,697,742,717,689,650,777,614,478,563,382,414,7847,8082,8523
E02003659,Waddesdon & Whitchurch,613,234,703,488,583,636,686,718,771,802,594,445,460,343,372,7601,7835,8448
E02003660,"Cheddington, Pitstone & Edlesborough",564,266,727,537,571,668,694,821,943,951,750,610,623,462,486,8843,9109,9673
E02003661,"Oakley, Brill & Edgcott",291,163,426,335,367,399,439,437,509,542,418,365,306,222,256,5021,5184,5475
E02003662,Watermead & Elmhurst,256,125,521,443,513,494,482,442,542,492,390,262,210,180,231,5202,5327,5583
E02003663,Berryfields & Haydon Hill,734,308,915,1055,1518,1559,1266,854,771,627,495,335,254,157,205,10011,10319,11053
E02003664,Gatehouse,437,176,624,595,758,808,702,526,504,499,343,234,234,144,270,6241,6417,6854
E02003665,Victoria Park,301,151,706,386,435,481,448,403,476,442,310,215,245,170,239,4956,5107,5408
E02003666,Aylesbury Central,301,143,578,802,846,756,577,540,522,483,397,285,241,185,308,6520,6663,6964
E02003667,Fairford Leys,447,201,545,629,783,798,755,700,687,613,419,351,315,199,189,6983,7184,7631
E02003668,Bedgrove & Walton,511,250,567,429,444,499,643,679,661,627,544,444,529,419,690,7175,7425,7936
E02003669,California & Southcourt,451,218,668,644,701,687,598,496,479,467,344,277,215,150,189,5915,6133,6584
E02003670,Mandeville & Elm Farm,431,191,658,661,738,733,768,680,665,645,551,455,372,291,364,7581,7772,8203
E02003671,Walton Court & Hawkslade,330,150,471,417,551,516,447,432,457,399,366,244,232,123,114,4769,4919,5249
E02003672,Stoke Mandeville & Aston Clinton,651,305,729,636,733,771,840,865,924,946,876,720,736,546,639,9961,10266,10917
E02003673,"Haddenham, Dinton & Stone",419,181,540,406,616,620,668,622,744,666,666,515,632,510,672,7877,8058,8477
E02003674,"Worminghall, Long Crendon & Cuddington",312,136,318,207,236,298,364,409,450,485,397,377,368,308,312,4529,4665,4977
E02003675,Wendover,464,322,1098,527,600,720,676,659,673,633,495,407,442,381,541,7852,8174,8638
E02003676,"Hyde Heath, Bellingdon & Latimer",478,202,563,357,320,378,493,595,731,794,669,545,554,470,538,7007,7209,7687
E02003677,Chesham West,580,296,835,569,735,787,833,785,795,725,582,465,457,350,455,8373,8669,9249
E02003678,Chesham East,344,158,378,313,397,398,497,476,442,444,402,287,291,210,356,4891,5049,5393
E02003679,Chesham South,311,139,430,550,623,622,568,499,499,485,414,298,277,241,375,5881,6020,6331
E02003680,Great Missenden & Prestwood,505,264,676,491,470,473,612,749,816,800,689,571,651,530,746,8274,8538,9043
E02003681,Amersham-on-the-Hill & Chesham Bois,697,286,650,555,537,662,850,863,827,773,642,507,509,491,781,8647,8933,9630
E02003682,Old Amersham,487,222,470,316,386,490,642,707,638,583,498,387,391,325,417,6250,6472,6959
E02003683,Little Chalfont,449,190,476,323,339,471,638,540,546,551,429,329,347,283,418,5690,5880,6329
E02003685,"Chalfont St Giles, Seer Green & Jordans",497,250,551,325,356,455,594,617,697,689,612,465,490,369,502,6722,6972,7469
E02003686,Chalfont Common & St Peter East,387,204,583,428,384,425,526,573,587,616,560,398,437,400,680,6597,6801,7188
E02003687,Chalfont St Peter West,363,164,442,292,299,337,415,453,477,441,434,315,295,223,373,4796,4960,5323
E02003688,Beaconsfield Town,767,313,874,644,730,823,969,1035,1075,970,723,571,567,486,916,10383,10696,11463
E02003689,Gerrards Cross,532,280,792,553,544,577,663,650,808,750,628,523,512,382,683,8065,8345,8877
E02003690,Denham,262,126,498,521,563,549,495,466,529,582,532,398,389,333,611,6466,6592,6854
E02003691,Farnham & Hedgerley,389,166,471,352,341,444,486,515,578,600,512,405,388,333,537,5962,6128,6517
E02003692,Stoke Poges & George Green,402,248,612,455,538,604,615,578,728,735,649,527,479,376,551,7447,7695,8097
E02003693,"Burham North, Taplow & Dorney",303,151,433,397,394,447,463,511,549,594,496,450,443,350,523,6050,6201,6504
E02003694,Burnham South,434,196,563,506,574,601,637,590,609,636,528,385,359,259,417,6664,6860,7294
E02003695,Iver & Richings Park,498,219,740,730,768,828,758,675,854,848,739,611,501,355,481,8888,9107,9605
E02003696,Princes Risborough,373,185,468,416,509,510,502,549,595,615,606,507,596,525,817,7215,7400,7773
E02003697,"Longwick, Kimble & Lacey Green",338,145,418,284,311,295,348,431,549,525,471,399,399,338,424,5192,5337,5675
E02003698,Walter's Ash & Hughenden Valley,379,202,573,376,403,419,466,523,698,669,599,494,599,482,558,6859,7061,7440
E02003699,Stokenchurch,282,135,399,295,351,380,353,391,468,422,404,359,332,258,323,4735,4870,5152
E02003701,Downley,636,292,1023,724,824,925,1035,861,849,819,587,482,489,459,655,9732,10024,10660
E02003702,"Bledlow, Cadmore End & Hambleden Valley",332,189,592,492,598,721,755,792,855,835,673,483,447,390,426,8059,8248,8580
E02003703,Terriers & Amersham Hill,474,208,728,700,833,776,689,661,613,633,466,364,270,233,286,7252,7460,7934
E02003704,Tylers Green,280,163,381,284,332,378,416,439,434,450,415,347,355,279,281,4791,4954,5234
E02003705,Bowerdean,430,221,663,644,714,637,664,557,457,424,350,287,188,122,199,5906,6127,6557
E02003706,Totteridge,385,173,545,491,565,574,551,464,486,409,335,265,234,174,265,5358,5531,5916
E02003707,Sands,336,152,525,550,658,626,549,480,480,394,306,224,209,126,152,5279,5431,5767
E02003708,Oakridge & Castlefield,641,298,1031,1050,1156,1077,1006,784,663,476,443,305,169,116,227,8503,8801,9442
E02003709,Micklefield,329,140,479,375,517,484,458,381,417,363,290,231,157,132,182,4466,4606,4935
E02003710,Town Centre & Marlow Hill,972,478,1383,1124,1316,1223,1108,933,782,628,532,397,332,273,394,10425,10903,11875
E02003711,Ryemead & Wycombe Marsh,470,178,611,722,946,922,792,636,635,579,433,374,323,224,327,7524,7702,8172
E02003712,Lane End & Booker,417,221,526,466,542,569,593,627,638,585,484,435,461,363,561,6850,7071,7488
E02003713,Flackwell Heath,333,144,368,265,328,355,378,401,441,462,383,367,346,304,469,4867,5011,5344
E02003714,Loudwater & Wooburn Green,326,162,412,369,467,524,494,538,510,482,398,390,323,271,279,5457,5619,5945
E02003715,"Marlow Bottom, Danesfield & Well End",431,197,441,250,201,289,421,520,574,562,434,434,442,371,349,5288,5485,5916
E02003716,Bourne End,242,124,315,248,305,332,349,381,453,451,409,346,360,320,449,4718,4842,5084
E02003717,Marlow West & North,564,246,529,390,407,504,669,743,763,697,574,520,551,491,701,7539,7785,8349
E02003718,Marlow East,334,177,322,310,344,382,482,483,440,434,356,313,281,244,355,4746,4923,5257
E02006823,Knotty Green & Holmer Green,473,219,573,408,383,472,574,667,713,713,638,559,584,519,712,7515,7734,8207
E02006824,Hazlemere,519,259,729,415,455,535,680,679,741,730,601,522,553,505,668,7813,8072,8591
E02004356,Langney West,397,207,640,507,558,548,446,454,554,594,510,404,347,293,351,6206,6413,6810
E02004357,Hampden Park North,468,224,653,509,535,591,517,545,560,524,454,406,405,265,273,6237,6461,6929
E02004358,Langney East,424,174,536,465,510,546,460,415,530,572,490,503,574,432,647,6680,6854,7278
E02004359,Hampden Park South,356,164,585,427,469,427,455,479,585,644,573,491,543,444,733,6855,7019,7375
E02004361,Ratton,494,209,587,389,393,443,510,599,597,662,549,486,512,408,627,6762,6971,7465
E02004362,Roselands,443,233,741,550,631,651,655,646,695,681,546,427,454,318,408,7403,7636,8079
E02004363,Upperton,270,144,422,462,525,393,476,432,509,521,460,379,445,375,719,6118,6262,6532
E02004364,Old Town & Motcombe,400,178,476,420,417,492,506,562,659,681,599,518,592,432,687,7041,7219,7619
E02004365,Pier,331,169,935,938,1023,908,803,665,701,618,529,352,262,132,202,8068,8237,8568
E02004366,King Edward's Parade,340,236,623,647,654,583,509,508,460,473,466,399,506,409,838,7075,7311,7651
E02004367,Meads,265,117,577,238,239,233,319,336,382,478,485,561,678,650,1150,6326,6443,6708
E02006857,St Anthony's Hill,447,193,625,446,561,604,631,525,610,672,587,540,661,510,632,7604,7797,8244
E02006858,Sovereign Harbour,308,149,504,363,388,373,378,455,568,535,559,560,623,483,419,6208,6357,6665
E02004368,Ashdown,455,200,645,474,544,500,540,556,638,729,590,500,461,325,342,6844,7044,7499
E02004369,Conquest & St Helens,404,222,583,431,506,514,511,579,729,787,760,715,888,723,932,8658,8880,9284
E02004370,Hollington,509,234,737,589,637,619,573,527,598,552,481,423,398,267,247,6648,6882,7391
E02004371,Ore,369,176,575,497,572,506,438,443,528,499,408,414,376,282,274,5812,5988,6357
E02004372,Broomgrove,483,199,625,584,622,582,487,424,492,521,404,314,273,172,229,5729,5928,6411
E02004373,Silverhill,452,195,683,512,576,618,556,562,633,724,559,508,504,373,395,7203,7398,7850
E02004374,Old Hastings,326,186,497,395,517,484,453,486,676,692,573,423,423,315,386,6320,6506,6832
E02004375,Braybrooke & Bohemia,364,218,559,499,646,560,576,623,764,725,591,516,490,245,392,7186,7404,7768
E02004376,Central Hastings,283,147,568,607,627,617,561,523,615,576,492,357,311,201,227,6282,6429,6712
E02004377,West St Leonards,513,237,711,615,696,702,645,724,846,866,745,698,681,465,743,9137,9374,9887
E02004378,Central St Leonards,271,119,534,647,804,773,686,668,727,738,584,482,418,297,290,7648,7767,8038
E02004379,"Chailey, Newick & Barcombe",416,217,510,347,369,355,503,572,664,632,549,501,523,412,432,6369,6586,7002
E02004380,"Wivelsfield Green, Ditchling & Rodmell",438,234,602,416,496,455,524,649,758,786,716,597,670,521,852,8042,8276,8714
E02004381,Lewes Central & East,520,247,722,559,603,646,633,683,791,862,700,544,552,421,557,8273,8520,9040
E02004382,"Ringmer, Glynde & South Heighton",342,152,409,269,355,371,412,469,506,463,463,461,492,404,611,5685,5837,6179
E02004383,Lewes West,452,224,681,488,534,464,518,643,734,696,515,458,442,300,453,6926,7150,7602
E02004384,East Saltdean & Telscombe Cliffs,306,151,566,348,396,459,482,471,627,601,485,458,485,365,494,6237,6388,6694
E02004385,Peacehaven West,319,165,576,450,456,476,477,488,564,559,558,538,523,449,572,6686,6851,7170
E02004386,Newhaven Town,289,145,441,361,526,432,390,377,472,492,464,425,434,364,391,5569,5714,6003
E02004387,Newhaven West,386,174,572,392,500,469,449,433,444,422,320,276,253,165,191,4886,5060,5446
E02004388,Peacehaven East,361,159,543,474,528,592,493,532,575,545,508,476,460,394,505,6625,6784,7145
E02004389,East Blatchington,301,154,483,364,384,477,412,444,634,756,772,797,902,774,1139,8338,8492,8793
E02004390,Seaford Eastbourne Road,368,185,510,352,380,418,417,467,554,568,576,598,750,607,748,6945,7130,7498
E02004391,Seaford Town,220,105,328,303,414,359,359,389,492,508,451,475,543,384,676,5681,5786,6006
E02004392,"Robertsbridge, Hurst Green & Ticehurst",459,211,649,433,505,480,560,602,763,790,713,643,637,503,556,7834,8045,8504
E02004393,"Northiam, Peasmarsh & Camber",258,128,397,277,276,291,292,367,517,601,605,584,608,502,577,5894,6022,6280
E02004394,"Burwash, Sedlescombe & Staplecross",348,178,524,371,390,337,405,445,638,809,718,627,641,499,579,6983,7161,7509
E02004395,Rye & Winchelsea,300,136,463,373,390,385,401,444,549,649,650,574,680,548,648,6754,6890,7190
E02004396,"Westfield, Fairlight & Broad Oak",432,252,537,392,391,360,417,527,694,850,811,840,977,760,843,8399,8651,9083
E02004397,Battle & Catsfield,519,256,636,386,403,450,461,574,622,719,618,550,578,483,636,7116,7372,7891
E02004398,Bexhill North & Sidley,572,236,801,670,686,627,520,573,631,685,556,454,483,388,550,7624,7860,8432
E02004399,Bexhill East & Pebsham,306,137,498,422,445,393,376,440,556,601,558,609,727,616,850,7091,7228,7534
E02004400,"Collington, Cooden & Little Common",320,144,502,382,381,391,382,474,663,836,908,984,1286,1036,1468,9693,9837,10157
E02004401,Kewhurst,246,97,377,311,312,293,321,324,435,579,573,650,870,723,1159,6927,7024,7270
E02004402,Bexhill Central,302,143,594,539,576,485,473,496,686,684,678,614,726,569,912,8032,8175,8477
E02004403,Forest Row & Coleman's Hatch,432,197,524,303,304,386,459,488,561,599,481,477,414,381,374,5751,5948,6380
E02004404,Frant & Groombridge,322,157,400,296,293,334,431,455,546,607,531,419,438,320,374,5444,5601,5923
E02004405,Crowborough North East,329,155,445,233,310,337,346,405,433,414,378,367,429,374,455,4926,5081,5410
E02004406,Crowborough Whitehill & Warren,309,144,471,346,310,367,384,453,571,593,563,529,633,549,785,6554,6698,7007
E02004407,Mayfield & Wadhurst,495,227,542,347,362,373,438,528,629,729,665,555,576,475,635,6854,7081,7576
E02004408,Crowborough South East,381,150,597,511,624,581,566,611,679,686,598,471,500,303,351,7078,7228,7609
E02004409,Chelwood & Nutley,241,115,377,234,222,244,297,385,456,515,483,398,418,324,393,4746,4861,5102
E02004410,"Buxted, Framfield & Rotherfield",382,190,490,338,346,372,429,565,703,753,696,608,635,521,521,6977,7167,7549
E02004411,Uckfield Town & North,414,187,594,465,559,542,521,541,626,656,562,504,575,483,494,7122,7309,7723
E02004412,Heathfield,356,174,542,436,458,479,379,535,624,635,589,493,573,468,549,6760,6934,7290
E02004413,Broad Oak & Horam,315,158,454,382,394,348,354,454,565,693,600,498,512,449,599,6302,6460,6775
E02004414,Uckfield South,320,145,487,396,402,406,430,500,596,544,437,328,348,242,282,5398,5543,5863
E02004415,"Five Ash Down, Horsted & Chiddingly",339,150,430,306,328,356,366,431,568,687,559,553,466,363,397,5810,5960,6299
E02004416,Herstmonceux & Ninfield,281,166,473,286,308,306,314,412,527,580,571,545,549,428,425,5724,5890,6171
E02004417,Hailsham Central & East,262,109,406,392,427,359,339,378,441,460,444,367,451,410,611,5485,5594,5856
E02004418,Hailsham South & West,258,131,393,330,344,308,295,341,385,429,381,346,373,334,465,4724,4855,5113
E02004419,Hailsham East,302,163,460,406,455,367,324,360,397,485,371,325,394,295,401,5040,5203,5505
E02004420,"Hailsham North, Alfriston & East Dean",748,681,1011,675,862,717,669,696,924,1022,999,898,1048,859,1073,11453,12134,12882
E02004421,Polegate,368,162,513,442,590,594,561,547,626,657,614,621,628,513,804,7710,7872,8240
E02004422,"Stone Cross, Westham & Pevensey Bay",464,231,805,571,661,630,575,670,845,876,803,740,850,631,792,9449,9680,10144
E02004423,Willingdon,281,122,458,324,325,340,390,418,582,638,597,537,705,606,780,6700,6822,7103
E02004675,Tadley West,386,175,567,494,534,539,461,504,581,569,565,411,429,345,383,6382,6557,6943
E02004676,"Tadley East, Pamber & Silchester",374,155,521,423,476,436,479,533,677,712,586,513,578,407,498,6839,6994,7368
E02004677,"Woolton Hill, Burghclere & Bishops Green",446,197,519,358,368,408,468,567,688,653,581,452,464,342,403,6271,6468,6914
E02004678,Kingsclere & Heath End,341,169,520,353,390,413,479,535,649,720,597,462,482,370,461,6431,6600,6941
E02004679,"Bramley, Sherfield & the Sherbornes",522,256,709,680,887,740,789,723,840,810,667,504,488,360,465,8662,8918,9440
E02004680,Chineham,361,162,479,522,641,662,673,659,648,547,469,347,296,205,173,6321,6483,6844
E02004681,Popley,830,350,1105,1211,1518,1420,1300,1062,950,702,565,407,461,344,362,11407,11757,12587
E02004682,Daneshill & Little Basing,390,170,609,554,651,677,706,667,642,597,540,371,324,241,250,6829,6999,7389
E02004683,Houndmills & Oakridge,347,185,638,735,819,747,631,538,613,534,412,288,282,237,370,6844,7029,7376
E02004684,Winklebury & Rooksdown,495,249,891,930,1186,1118,903,818,758,709,489,335,382,288,358,9165,9414,9909
E02004685,"Basingstoke Central, Black Dam & Eastrop",289,148,667,856,1069,867,705,564,535,531,372,291,298,200,342,7297,7445,7734
E02004686,Kings Furlong,387,151,704,797,1007,1028,778,663,641,530,424,314,320,231,309,7746,7897,8284
E02004687,Buckskin & Worting,482,209,655,512,701,720,576,571,555,498,356,266,272,223,213,6118,6327,6809
E02004688,South Ham & West Ham,355,169,623,610,665,646,553,551,569,604,488,380,357,252,425,6723,6892,7247
E02004689,East Oakley,252,115,335,245,285,341,367,383,384,439,384,401,497,399,431,4891,5006,5258
E02004690,Viables,373,176,640,538,641,603,639,554,637,638,497,387,431,274,359,6838,7014,7387
E02004691,Old Basing & the Candovers,353,140,515,363,356,387,474,526,674,800,634,566,514,432,657,6898,7038,7391
E02004692,Kempshott,313,159,434,272,317,401,430,499,620,584,489,563,622,503,518,6252,6411,6724
E02004693,Brighton Hill,346,149,557,518,641,626,583,512,553,544,408,354,346,197,235,6074,6223,6569
E02004694,Whitchurch & Ashmansworth,356,141,499,383,451,501,537,551,594,574,479,428,434,339,434,6204,6345,6701
E02004695,Hatch Warren,529,271,761,596,580,671,750,851,771,711,470,360,242,165,124,7052,7323,7852
E02004696,Overton & North Waltham,351,121,472,408,459,472,523,547,582,537,448,418,468,360,394,6088,6209,6560
E02004697,Bentley & Holybourne,370,179,489,338,310,342,417,503,573,588,492,419,423,320,466,5680,5859,6229
E02004698,Alton Westbrooke & Eastbrooke,328,144,469,518,528,443,424,443,454,422,361,288,300,230,458,5338,5482,5810
E02004699,"Alton Ashdell, Whitedown & Amery",470,257,737,613,599,664,680,747,826,826,769,637,693,584,764,9139,9396,9866
E02004700,Bordon Camp,311,118,488,561,704,581,502,430,454,479,344,240,197,130,126,5236,5354,5665
E02004702,Bordon & Lindford,381,175,621,503,568,564,548,542,630,656,614,420,392,297,318,6673,6848,7229
E02004703,Four Marks & Tisted,619,338,852,534,600,593,745,878,1088,1130,1010,848,953,674,765,10670,11008,11627
E02004704,Whitehill & Selborne,285,159,405,332,347,392,388,360,533,542,474,381,378,288,314,5134,5293,5578
E02004705,Liphook,537,236,630,478,515,579,628,784,770,720,595,538,540,471,734,7982,8218,8755
E02004706,Liss & Hawkley,390,189,489,331,363,348,491,513,646,649,549,470,505,444,597,6395,6584,6974
E02004707,Petersfield North & East Meon,724,387,751,500,498,514,669,775,896,947,897,784,758,608,839,9436,9823,10547
E02004708,Petersfield South,477,219,641,596,615,692,614,678,682,631,617,514,522,426,645,7873,8092,8569
E02004709,Clanfield & Finchdean,370,212,553,461,510,514,547,543,659,713,670,562,564,430,468,7194,7406,7776
E02004710,Horndean North,308,175,452,347,388,407,355,441,490,562,551,399,444,356,370,5562,5737,6045
E02006829,Horndean South & Rowlands Castle,294,166,420,359,402,391,395,455,563,648,531,524,495,455,630,6268,6434,6728
E02006838,Headley Down & Grayshott,273,154,413,260,301,321,403,461,540,619,580,483,551,459,645,6036,6190,6463
E02004712,Hiltingbury,621,267,502,329,335,404,657,739,667,640,539,425,540,525,775,7077,7344,7965
E02004713,Chandler's Ford East,423,177,497,394,481,588,571,542,557,503,540,527,565,404,509,6678,6855,7278
E02004714,Chandler's Ford West,310,156,431,366,466,463,482,527,562,569,505,546,575,394,541,6427,6583,6893
E02004715,Boyatt Wood,408,201,603,600,780,780,605,498,564,564,538,455,426,299,474,7186,7387,7795
E02004716,Bishopstoke,457,187,605,539,605,614,616,501,669,650,603,520,467,362,435,7186,7373,7830
E02004717,Eastleigh West,708,333,978,921,1214,1087,945,850,835,751,561,460,415,308,486,9811,10144,10852
E02004718,Central Eastleigh,404,180,701,737,875,816,716,598,617,577,477,394,300,191,287,7286,7466,7870
E02004719,Fair Oak,558,260,879,727,765,758,737,800,886,887,779,606,626,476,585,9511,9771,10329
E02004720,West End & Chartwell Green,473,217,713,716,756,712,677,735,808,924,855,733,709,579,795,9712,9929,10402
E02004721,Hedge End North & Botley North,671,284,815,737,966,950,953,888,843,726,538,353,326,217,265,8577,8861,9532
E02004722,Hedge End Wildern & Botley South,344,152,478,413,465,431,437,417,487,518,510,440,405,346,480,5827,5979,6323
E02004723,Hedge End South,455,231,646,582,669,610,676,621,708,706,613,587,577,458,664,8117,8348,8803
E02004724,Lowford,402,201,640,676,793,673,619,613,716,649,568,458,396,315,352,7468,7669,8071
E02004725,Netley,249,111,323,316,335,361,355,367,382,422,390,341,334,258,413,4597,4708,4957
E02004726,Hamble-le-Rice,248,105,372,307,397,401,433,384,511,518,428,369,369,275,330,5094,5199,5447
E02004727,Swanwick & Sarisbury Green,612,292,685,511,603,671,790,806,849,812,607,427,440,303,391,7895,8187,8799
E02004728,Park Gate & Segensworth,410,203,674,519,578,593,521,625,671,742,583,471,502,383,551,7413,7616,8026
E02004729,Fareham North West,320,175,522,485,519,502,443,419,557,552,458,396,413,356,434,6056,6231,6551
E02004730,Fareham Common,373,171,568,368,493,467,523,503,690,737,639,560,597,545,802,7492,7663,8036
E02004731,Locks Heath,326,192,510,388,412,461,453,494,608,653,600,496,481,379,501,6436,6628,6954
E02004732,Warsash,408,213,574,463,562,544,529,618,646,715,703,520,566,433,613,7486,7699,8107
E02004733,Titchfield & Titchfield Common,360,166,483,438,517,490,481,499,561,634,619,486,498,368,446,6520,6686,7046
E02004734,Fareham Town & Cams Hill,452,217,734,591,610,639,597,689,815,853,737,566,603,491,730,8655,8872,9324
E02004735,Fareham West,267,128,357,313,394,400,331,398,538,557,607,473,555,535,703,6161,6289,6556
E02004736,Portchester North West,324,164,488,381,488,478,461,543,599,613,594,524,645,554,622,6990,7154,7478
E02004737,Fareham Fort,344,154,549,535,590,559,473,433,519,534,460,327,326,269,415,5989,6143,6487
E02004738,Portchester South East,304,148,513,355,460,425,442,505,544,603,532,480,509,388,518,6274,6422,6726
E02004739,Stubbington,284,233,1310,735,700,585,493,473,558,593,512,507,585,506,735,8292,8525,8809
E02004740,Hill Head,285,148,378,248,288,313,344,403,495,560,552,532,582,521,700,5916,6064,6349
E02004741,Bridgemary North,384,185,588,438,526,492,438,462,538,634,564,454,534,380,461,6509,6694,7078
E02004742,Bridgemary South,326,136,496,427,454,481,419,392,485,537,578,483,459,347,419,5977,6113,6439
E02004743,Elson,343,129,516,434,453,475,424,455,570,583,511,395,421,317,323,5877,6006,6349
E02004744,Rowner,616,294,827,730,815,790,630,549,572,525,428,296,248,144,216,6770,7064,7680
E02004745,Priddy's Hard & Brockhurst East,401,186,659,572,609,596,509,571,690,687,537,422,410,273,300,6835,7021,7422
E02004746,Lee-on-the-Solent,603,272,690,450,476,575,631,742,793,812,814,740,892,694,869,9178,9450,10053
E02004747,Brockhurst,239,201,1008,752,634,617,491,403,512,552,437,382,344,253,353,6738,6939,7178
E02004748,Gosport Town,394,173,720,659,744,628,583,547,651,738,624,465,471,391,433,7654,7827,8221
E02004749,Alverstoke & Privett,356,160,412,261,250,341,365,409,495,568,517,497,563,464,747,5889,6049,6405
E02004750,Clayhall & Anglesey,304,131,473,367,432,378,396,449,573,628,628,503,503,378,573,6281,6412,6716
E02004751,Yateley East,362,188,619,453,477,506,530,557,656,658,527,496,508,498,604,7089,7277,7639
E02004752,Yateley West & Eversley,415,224,538,401,446,479,529,583,627,644,546,525,528,369,356,6571,6795,7210
E02004753,"Blackwater, Frogmore & Minley",495,374,1110,827,961,879,781,784,761,800,663,527,619,510,567,9789,10163,10658
E02004754,Hartley Wintney & Heckfield,336,164,428,291,424,444,460,563,578,575,483,413,486,393,463,6001,6165,6501
E02004755,"Fleet North, Elvetham Heath & Ancells Farm",697,308,875,780,905,934,1092,1170,986,812,600,399,387,380,655,9975,10283,10980
E02004756,Hook & Rotherwick,499,266,682,580,644,656,694,726,782,764,660,433,477,311,328,7737,8003,8502
E02004757,Fleet South & Pondtail,419,207,568,353,320,444,528,650,714,661,528,446,590,439,651,6892,7099,7518
E02004758,Fleet West & Winchfield,504,202,624,433,526,598,680,794,788,781,561,482,483,408,541,7699,7901,8405
E02004759,Crookham East,461,225,546,337,461,492,588,652,691,645,470,405,441,395,572,6695,6920,7381
E02004760,"Crookham West, Ewshot & Crondall",574,262,694,562,713,829,805,808,723,765,552,397,384,322,505,8059,8321,8895
E02004761,Odiham & Warnborough,346,179,793,626,621,584,523,458,450,433,375,300,345,267,377,6152,6331,6677
E02004764,Waterlooville North West,314,177,563,433,453,431,353,410,596,744,650,542,654,544,817,7190,7367,7681
E02004765,Waterlooville North East,237,104,398,342,379,357,345,344,457,485,437,411,393,321,393,5062,5166,5403
E02004766,Waterlooville Central,311,193,555,477,533,465,411,419,510,502,459,353,344,276,477,5781,5974,6285
E02004767,Barncroft & Warren Park,367,174,517,398,458,430,381,337,392,414,347,263,197,176,211,4521,4695,5062
E02004768,Waterlooville East,276,156,412,339,443,376,336,359,386,397,391,345,299,193,202,4478,4634,4910
E02004769,Leigh Park,394,155,547,494,569,515,398,352,491,435,385,278,228,155,186,5033,5188,5582
E02004770,West Leigh,393,156,546,514,577,536,435,444,469,516,411,296,269,209,294,5516,5672,6065
E02004771,Stockheath Common,549,245,727,605,732,672,580,527,631,630,533,404,357,231,346,6975,7220,7769
E02004772,Purbrook & Widley,390,202,681,520,567,516,525,615,796,776,707,579,595,471,597,7945,8147,8537
E02004774,Emsworth,409,201,562,443,465,548,541,619,695,766,808,802,785,702,1113,8849,9050,9459
E02004775,Central Havant & Langstone,439,201,761,594,657,668,664,634,777,788,739,669,656,493,695,8795,8996,9435
E02004776,Hayling West & North,205,118,387,248,218,242,293,332,459,513,570,505,566,517,581,5431,5549,5754
E02004777,South Hayling,195,94,281,229,250,213,217,290,387,437,451,402,481,470,638,4746,4840,5035
E02004778,Hayling Eastoke,187,104,309,265,315,268,253,321,477,554,554,510,628,502,638,5594,5698,5885
E02006822,Bedhampton,415,201,626,534,594,642,543,520,682,810,681,550,569,419,616,7786,7987,8402
E02006830,Cowplain West,370,154,521,513,534,461,410,423,472,458,375,304,335,262,282,5350,5504,5874
E02006831,Cowplain East,238,114,368,324,373,370,302,334,453,481,501,432,468,375,539,5320,5434,5672
E02004779,"Fordingbridge, Rockbourne & Woodgreen",439,195,684,490,509,529,576,591,856,993,910,845,880,672,961,9496,9691,10130
E02004780,Totton Calmore,264,121,435,370,422,398,372,341,463,448,394,350,374,264,336,4967,5088,5352
E02004781,West Totton,390,186,601,527,547,585,558,583,643,648,562,418,432,272,322,6698,6884,7274
E02004782,Totton Town,384,169,572,505,524,507,551,508,638,593,487,434,440,347,553,6659,6828,7212
E02004783,Totton Rushington,349,175,495,396,499,471,484,497,543,600,535,359,333,252,382,5846,6021,6370
E02004784,Ashurst & Cadnam,207,109,344,196,227,246,272,369,438,527,451,403,480,360,620,4933,5042,5249
E02004785,Lyndhurst & Minstead,205,108,306,254,237,244,315,351,468,531,488,427,483,375,503,4982,5090,5295
E02004786,Marchwood & Dibden,392,193,522,510,536,522,503,538,621,662,545,527,426,343,312,6567,6760,7152
E02004787,Hythe,238,130,389,359,366,385,337,387,519,607,593,528,678,556,833,6537,6667,6905
E02004788,Ringwood North & Ibsley,374,201,507,323,346,304,416,517,612,651,561,499,528,438,485,6187,6388,6762
E02004789,Langdown & Dibden Purlieu,528,264,776,563,686,602,584,603,767,870,738,626,606,508,823,8752,9016,9544
E02004790,Ringwood South,352,166,556,484,571,511,491,523,567,609,506,409,510,429,698,6864,7030,7382
E02004791,Holbury South,350,179,427,332,390,369,310,343,409,397,332,317,317,241,250,4434,4613,4963
E02004792,"Holbury North, Blackfield & Fawley",342,150,490,429,536,422,415,481,624,726,725,692,714,520,647,7421,7571,7913
E02004793,Brockenhurst & Sway,315,152,470,278,278,340,391,454,583,665,619,563,677,534,809,6661,6813,7128
E02004794,Bransgore & Burley,340,142,412,265,302,326,418,407,531,594,595,577,605,413,537,5982,6124,6464
E02004795,Lymington Town & Boldre,367,161,522,391,374,440,458,584,648,707,673,682,753,607,920,7759,7920,8287
E02004796,Hordle & Bashley,347,193,555,368,402,411,434,532,669,818,801,779,987,808,967,8531,8724,9071
E02004797,Lymington North & West,375,172,556,444,502,504,521,497,600,699,609,521,520,410,518,6901,7073,7448
E02004798,New Milton West,330,143,495,381,381,379,343,418,462,523,412,342,384,340,437,5297,5440,5770
E02004799,New Milton East,265,118,475,403,477,437,442,430,501,532,571,521,685,625,1056,7155,7273,7538
E02004800,Barton on Sea,157,87,300,212,215,218,267,303,403,619,698,783,934,830,1193,6975,7062,7219
E02004801,Milford & Lymington South,266,123,332,248,197,280,301,359,527,607,660,665,914,818,1169,7077,7200,7466
E02004802,Hawley Lane & Fox Lane,269,156,520,517,575,538,408,422,524,545,424,329,338,264,351,5755,5911,6180
E02004803,Mayfield,397,195,640,644,734,590,527,503,654,549,407,313,351,246,243,6401,6596,6993
E02004804,Pinewood,335,174,491,414,558,526,473,530,519,576,415,369,403,287,283,5844,6018,6353
E02004805,Farnborough Hill,377,206,578,539,700,764,643,615,640,631,510,416,454,369,441,7300,7506,7883
E02004806,Cove & Southwood,371,203,559,454,608,603,551,616,615,643,528,382,361,235,268,6423,6626,6997
E02004807,Farnborough Town,433,204,622,632,868,834,687,647,662,689,508,425,405,359,475,7813,8017,8450
E02004808,South Farnborough & North Camp,530,266,786,822,1026,973,925,807,872,703,535,407,353,279,387,8875,9141,9671
E02004809,Aldershot Town,458,185,1656,1759,1962,1506,1160,738,522,418,332,249,320,234,180,11036,11221,11679
E02004810,Aldershot North Town,376,161,623,682,772,762,650,555,645,559,410,281,259,201,217,6616,6777,7153
E02004811,Aldershot Rowhill,306,154,606,575,669,617,590,585,619,617,526,424,426,360,451,7065,7219,7525
E02004812,Aldershot Manor Park,292,150,528,467,561,486,522,503,548,571,428,351,321,248,245,5779,5929,6221
E02004813,Aldershot Park,290,163,502,450,465,482,468,438,488,510,397,305,272,213,304,5294,5457,5747
E02004814,Andover Charlton & Bourne Valley,304,164,484,410,415,400,400,529,650,644,534,391,418,318,329,5922,6086,6390
E02004815,Andover Newbury Road,525,220,663,592,715,660,585,555,565,478,369,256,232,174,154,5998,6218,6743
E02004816,Andover London Road & East Anton,905,364,1317,1724,2056,1840,1473,1203,1218,1140,875,617,624,511,548,15146,15510,16415
E02004817,Andover Central,347,175,579,492,622,559,534,558,602,611,483,379,400,277,416,6512,6687,7034
E02004818,Andover West,417,218,715,474,505,556,601,715,767,785,582,543,649,519,686,8097,8315,8732
E02004819,Andover South,334,163,551,499,507,483,512,532,670,703,510,409,387,384,583,6730,6893,7227
E02004820,Over Wallop & Shipton Bellinger,306,156,666,535,610,656,555,531,709,631,481,416,449,318,396,6953,7109,7415
E02004821,"Chilbolton, Clatford & Barton Stacey",216,82,299,198,216,247,296,327,402,463,444,346,421,364,348,4371,4453,4669
E02004822,"Nether Wallop, Kings Somborne & Dunbridge",348,181,461,323,364,392,444,552,686,743,719,591,569,421,528,6793,6974,7322
E02004823,Romsey Cupernham & Halterworth,375,194,482,460,524,554,503,590,617,648,616,577,643,561,613,7388,7582,7957
E02004824,Romsey Town,167,90,350,343,323,280,303,290,358,462,424,341,498,423,823,5218,5308,5475
E02004825,North Baddesley & Braishfield,531,225,643,508,599,580,675,781,761,831,811,655,797,674,803,9118,9343,9874
E02004826,Abbotswood & West Wellow,449,245,632,532,617,715,672,621,714,737,659,570,603,491,583,8146,8391,8840
E02004827,Valley Park,424,203,544,370,383,533,603,656,633,624,541,381,342,218,229,6057,6260,6684
E02004828,"Chilworth, Nursling & Rownhams",338,177,522,435,463,441,478,549,520,553,528,523,486,327,446,6271,6448,6786
E02004829,"South Wonston, Sutton Scotney & Micheldever",283,136,338,251,325,333,374,434,454,409,386,336,348,243,326,4557,4693,4976
E02004830,Springvale & Itchen Abbas,335,190,1057,695,676,715,706,600,621,555,475,381,389,313,350,7533,7723,8058
E02004831,Winchester North & Sparsholt,551,375,808,449,532,670,710,804,718,670,550,497,533,459,902,8302,8677,9228
E02004832,New Alresford,414,240,626,350,349,374,477,593,713,682,650,557,625,604,791,7391,7631,8045
E02004833,Winchester West,535,255,1682,769,719,739,780,798,738,675,575,449,453,375,581,9333,9588,10123
E02004834,Winchester East,411,197,1221,865,650,593,571,499,556,506,423,365,300,262,377,7188,7385,7796
E02004835,Winchester Central & South,672,448,1767,884,810,825,779,725,741,701,581,451,469,411,623,9767,10215,10887
E02004836,Winchester Stanmore,351,198,2140,474,361,307,301,378,342,318,264,211,195,152,182,5625,5823,6174
E02004837,Oliver's Battery and Hursley,471,194,727,471,494,479,568,572,646,625,555,415,526,380,487,6945,7139,7610
E02004838,Colden Common & Twyford,547,250,587,401,502,578,682,746,739,726,682,553,635,443,595,7869,8119,8666
E02004839,"Swanmore, Hambledon & West Meon",430,230,606,354,423,478,531,603,704,806,751,689,585,462,556,7548,7778,8208
E02004840,Bishop's Waltham & Waltham Chase,424,233,663,516,664,625,656,615,751,820,742,631,708,569,705,8665,8898,9322
E02004841,"Whiteley, Knowle & Wickham",536,293,864,702,842,883,829,840,995,976,701,581,620,432,606,9871,10164,10700
E02004842,Denmead & Southwick,491,247,728,673,762,713,695,669,732,871,727,654,606,464,713,9007,9254,9745
E02004996,"Wye, Chilham & Kennington",529,211,567,414,529,531,609,681,747,630,538,480,510,416,479,7131,7342,7871
E02004997,"Charing, Pluckley & Challock",433,201,591,394,407,439,509,560,742,746,687,567,643,478,561,7324,7525,7958
E02004998,Kennington & Little Burton Farm,390,181,541,372,414,363,430,466,604,541,402,363,403,354,405,5658,5839,6229
E02004999,"Bybrook, Orchard Park & Godinton",898,398,1194,1179,1400,1239,1192,1109,1093,1013,779,699,702,530,638,12767,13165,14063
E02005000,Ashford Central,615,326,1067,1142,1233,1119,888,812,844,731,551,418,404,313,339,9861,10187,10802
E02005001,Highfield & Willesborough,504,240,728,596,745,696,702,692,776,685,575,545,569,394,475,8178,8418,8922
E02005002,Beaver & Singtleton,492,238,726,731,904,836,725,604,673,634,524,410,418,309,366,7860,8098,8590
E02005003,Washford & Stanhope,630,355,1069,839,874,774,714,574,642,602,445,330,337,236,220,7656,8011,8641
E02005004,Park Farm,717,343,1063,872,959,927,908,884,1054,840,627,440,388,273,348,9583,9926,10643
E02005005,Brabourne Lees & North Romney,532,245,633,570,703,725,662,718,768,757,663,593,606,444,462,8304,8549,9081
E02005006,"Biddenden, Smarden & High Halden",318,148,418,319,307,307,297,417,549,620,516,400,491,381,446,5468,5616,5934
E02005007,"Great Chart, Bethersden & Woodchurch",508,229,685,520,606,584,587,650,781,757,624,606,564,469,559,7992,8221,8729
E02005008,Tenterden & Rolvenden,320,175,589,369,407,387,361,458,605,699,645,625,763,717,968,7593,7768,8088
E02005009,Hamstreet & Isle of Oxney,319,150,375,282,296,302,356,376,487,487,481,431,487,414,391,5165,5315,5634
E02005010,Herne Bay Parade,326,167,596,514,540,534,450,521,591,551,547,446,439,359,540,6628,6795,7121
E02005011,Beltinge & Bishopstone,290,156,490,305,326,336,368,400,525,595,628,638,750,608,735,6704,6860,7150
E02005012,Herne Bay South & Greenhill,469,214,739,481,519,504,523,547,648,721,566,637,621,524,578,7608,7822,8291
E02005013,"Hampton, West End & Swalecliffe",388,191,610,442,441,426,404,539,590,726,641,565,674,526,635,7219,7410,7798
E02005014,Chestfield & South Tankerton,349,171,521,351,371,360,439,467,670,733,686,718,842,656,826,7640,7811,8160
E02005015,Herne & Broomfield,512,236,717,563,660,631,597,614,689,701,622,568,589,441,495,7887,8123,8635
E02005016,Whitstable Central & Tankerton,400,179,564,422,391,446,493,538,644,700,606,545,542,415,535,6841,7020,7420
E02005017,Whitstable West,266,147,430,318,366,412,475,575,574,653,523,433,473,339,447,6018,6165,6431
E02005018,Seasalter,435,195,590,462,489,517,527,596,702,746,656,616,692,546,617,7756,7951,8386
E02005019,"Hoath, Hersden & Littlebourne",351,159,576,469,514,505,495,474,521,523,459,434,434,300,467,6171,6330,6681
E02005020,Sturry and Fordwich,424,205,623,534,523,538,529,477,529,546,500,455,446,366,431,6497,6702,7126
E02005021,"Blean Forest, Chartham Hatch & University",473,392,6349,1514,601,506,450,507,440,465,434,388,502,404,501,13061,13453,13926
E02005022,Canterbury St Stephen's,308,148,2015,756,515,436,419,373,373,380,351,248,277,207,255,6605,6753,7061
E02005023,Canterbury Barracks,481,213,2191,1297,1072,713,634,497,538,392,337,267,255,170,276,8639,8852,9333
E02005025,South Canterbury,407,380,2978,1255,841,617,587,535,592,473,455,440,478,331,496,10078,10458,10865
E02005026,Thanington & Chartham,450,214,599,440,578,632,560,661,626,629,519,470,454,323,358,6849,7063,7513
E02005027,"Bridge, Bishopsbourne & Barham",271,149,372,300,275,308,314,367,448,482,463,374,393,318,449,4863,5012,5283
E02006855,Canterbury Wincheap,289,116,976,760,695,622,523,414,376,338,293,213,194,123,172,5699,5815,6104
E02006856,Canterbury Central & Westgate,811,547,2171,1436,1152,946,772,612,532,534,440,407,402,308,530,10242,10789,11600
E02005028,Temple Hill & Marshes,868,337,824,973,1452,1682,1350,917,696,561,401,317,253,160,293,9879,10216,11084
E02005029,Ebbsfleet & Greenhithe,725,285,799,1137,1637,1634,1271,974,810,659,479,338,290,178,194,10400,10685,11410
E02005030,Central Dartford & West Hill,711,313,854,889,1111,1143,1161,909,881,734,594,379,341,276,334,9606,9919,10630
E02005031,Swanscombe,464,192,649,598,749,716,629,566,574,528,398,302,244,171,234,6358,6550,7014
E02005032,Newtown,507,237,681,724,968,933,794,714,768,605,463,294,305,177,244,7670,7907,8414
E02005033,Stone & Crossways,440,157,469,532,672,653,592,512,540,477,399,269,280,183,188,5766,5923,6363
E02005034,Heath,470,223,598,430,490,502,576,612,574,610,475,363,435,283,371,6319,6542,7012
E02005035,Brent & Fleet Estate,515,252,629,474,615,671,723,673,607,620,461,397,376,288,439,6973,7225,7740
E02005036,Tree Estate,468,180,553,456,481,562,561,492,490,434,326,290,248,174,219,5286,5466,5934
E02005037,Joydens Wood,380,198,535,394,410,407,445,468,589,528,460,363,425,329,566,5919,6117,6497
E02005038,Wilmington & Hawley,334,138,434,303,331,344,363,396,413,461,405,340,375,278,444,4887,5025,5359
E02005039,"Bean, Darenth & Sutton at Hone",374,165,514,423,507,544,444,428,527,531,459,390,340,270,315,5692,5857,6231
E02005040,"Longfield, New Barn & Southfleet",313,135,455,339,355,393,408,402,510,570,534,481,445,383,596,5871,6006,6319
E02005041,Ash & Wingham,371,177,469,323,388,406,406,469,604,643,590,477,538,426,448,6187,6364,6735
E02005042,Sandwich & Eastry,416,221,605,416,454,430,418,540,662,782,790,682,741,563,726,7809,8030,8446
E02005043,Deal North & West,279,132,431,397,406,308,398,430,560,638,571,530,567,437,595,6268,6400,6679
E02005044,Deal East,195,97,310,295,335,277,314,308,478,645,530,486,574,433,494,5479,5576,5771
E02005045,"Mill Hill, Upper Deal & Northbourne",536,181,654,583,663,602,546,548,632,703,597,574,487,427,446,7462,7643,8179
E02005046,Aylesham & Elvington,478,237,653,697,793,682,559,479,584,562,461,378,389,309,320,6866,7103,7581
E02005047,Walmer,373,180,526,392,482,416,409,451,551,626,538,586,515,482,598,6572,6752,7125
E02005048,Eythorne & Shepherdswell,275,134,399,301,289,319,350,424,492,614,593,571,519,371,479,5721,5855,6130
E02005049,Kingsdown & St Margaret's-at-Cliffe,239,130,320,224,223,304,301,338,439,577,654,672,721,610,681,6064,6194,6433
E02005050,"Kearsney, River & Whitfield",423,203,622,520,565,575,574,565,676,728,642,592,678,544,734,8015,8218,8641
E02005051,Buckland & St Radigunds,810,342,1195,1081,1044,1009,913,903,901,915,710,565,531,320,372,10459,10801,11611
E02005052,Dover East,596,337,692,577,645,565,499,516,563,556,563,458,404,313,408,6759,7096,7692
E02005053,Dover West,529,298,1041,758,748,714,633,549,678,617,559,438,349,221,281,7586,7884,8413
E02005054,Elms Vale & Capel-le-Ferne,246,142,368,320,324,341,363,394,498,613,567,516,589,406,444,5743,5885,6131
E02005055,Northfleet North,580,206,716,655,862,813,656,618,549,520,370,273,229,158,179,6598,6804,7384
E02005056,Gravesend Town,478,233,913,1063,1197,1189,963,791,811,700,522,400,366,243,412,9570,9803,10281
E02005057,Milton & Chalk,688,338,1031,858,1045,1049,1003,833,855,784,589,419,400,278,415,9559,9897,10585
E02005058,Perry Street,466,223,674,575,721,732,642,548,603,498,430,340,307,206,283,6559,6782,7248
E02005059,Windmill Hill,462,245,762,630,712,717,715,634,749,740,636,522,438,342,505,8102,8347,8809
E02005060,Northfleet South,502,212,669,561,702,685,568,570,530,577,458,380,369,292,472,6833,7045,7547
E02005061,Westcourt,545,238,686,503,506,582,544,530,598,473,397,329,317,272,352,6089,6327,6872
E02005062,Riverview Park,449,183,570,414,483,490,484,448,531,473,399,347,363,297,403,5702,5885,6334
E02005063,Gravesend South & Coldharbour,442,207,558,464,520,535,485,505,536,501,490,354,340,262,355,5905,6112,6554
E02005064,Higham & Shorne,315,191,603,322,355,358,372,457,483,538,467,447,469,385,464,5720,5911,6226
E02005065,Singlewell,532,245,704,590,659,668,601,528,591,557,412,298,310,229,329,6476,6721,7253
E02005066,Istead Rise & Meopham,353,156,497,404,434,425,463,446,611,679,546,524,602,503,641,6775,6931,7284
E02005067,Sole Street & Vigo,319,156,455,331,334,348,348,398,497,519,428,399,426,322,342,5147,5303,5622
E02005068,Boxley & Detling,348,176,467,400,486,478,501,479,614,609,512,407,376,237,240,5806,5982,6330
E02005069,Penenden Heath,461,216,594,498,596,687,713,639,644,620,478,475,520,350,467,7281,7497,7958
E02005070,Allington,471,214,569,450,518,532,615,673,686,698,588,521,701,571,887,8009,8223,8694
E02005071,Ringlestone & Central Maidstone,386,172,1239,1423,1543,1234,1055,829,741,638,489,404,316,216,357,10484,10656,11042
E02005072,Grove Green,428,206,483,333,452,542,557,617,566,556,502,519,583,419,428,6557,6763,7191
E02005073,Maidstone West,496,206,955,1090,1323,1176,1054,896,841,775,552,411,402,256,436,10167,10373,10869
E02005074,Bearsted & Downswood,434,203,466,353,431,516,554,623,553,581,546,471,596,444,660,6794,6997,7431
E02005075,Barming,617,302,859,780,917,904,830,839,807,702,520,437,354,295,348,8592,8894,9511
E02005076,Tovil,498,235,758,788,940,920,807,688,682,629,468,315,280,188,323,7786,8021,8519
E02005077,Mote Park,453,235,625,528,575,539,538,573,599,578,460,410,435,322,392,6574,6809,7262
E02005078,"Harrietsham, Hollingbourne & Lenham",444,215,653,511,592,569,560,626,805,823,730,665,718,523,619,8394,8609,9053
E02005079,Loose Valley & Boughton Monchelsea,463,215,602,431,478,590,583,564,657,618,575,462,572,484,579,7195,7410,7873
E02005080,Parkwood & Senacre,729,291,934,892,1051,990,765,734,781,728,588,441,495,409,521,9329,9620,10349
E02005081,Yalding & Farleigh,323,164,440,342,376,361,413,487,592,588,546,516,518,430,545,6154,6318,6641
E02005082,"Kingswood, Langley Heath & Chart Sutton",608,268,832,845,1112,998,872,792,915,903,792,590,602,447,534,10234,10502,11110
E02005083,Loose & Coxheath,384,144,548,508,522,501,487,491,571,604,481,436,482,409,482,6522,6666,7050
E02005084,Headcorn & Sutton Valence,373,179,548,467,472,524,484,506,627,642,605,428,459,379,455,6596,6775,7148
E02005085,Marden,388,176,621,513,643,612,528,589,663,710,563,443,416,276,367,6944,7120,7508
E02005086,Staplehurst,339,180,478,408,435,456,373,443,532,527,413,403,413,334,382,5597,5777,6116
E02005087,Swanley East & Hextable,344,167,522,403,485,482,464,438,501,561,497,434,484,335,464,6070,6237,6581
E02005088,Swanley West,583,234,808,667,684,751,686,625,698,670,571,441,469,300,490,7860,8094,8677
E02005089,Swanley South & Crockenhill,315,147,436,467,560,488,436,381,486,508,424,360,346,311,388,5591,5738,6053
E02005090,Hartley & Hodsoll Street,240,151,445,241,244,312,313,345,428,481,426,371,465,455,611,5137,5288,5528
E02005091,Darenth Valley,319,153,468,353,440,408,450,414,519,521,461,457,403,345,454,5693,5846,6165
E02005093,West Kingsdown,251,129,399,289,317,316,348,362,442,495,471,427,495,400,429,5190,5319,5570
E02005094,"Knockholt, Shoreham & Dunton Green",484,216,602,538,669,744,702,681,725,721,571,488,489,384,518,7832,8048,8532
E02005095,Kemsing & Otford,427,206,499,369,350,438,524,626,605,568,486,395,417,383,526,6186,6392,6819
E02005096,Sevenoaks North,610,210,611,563,661,823,836,844,707,658,536,404,480,328,524,7975,8185,8795
E02005097,Sevenoaks West & Chevening,733,331,606,360,433,590,766,897,841,744,486,445,464,385,544,7561,7892,8625
E02005098,Sevenoaks Town & Weald,810,528,672,545,556,589,759,813,883,793,617,440,513,451,838,8469,8997,9807
E02005099,Westerham & Brasted,386,186,520,384,425,439,465,541,682,703,554,518,483,384,459,6557,6743,7129
E02005100,Edenbridge,486,237,650,556,701,718,702,650,685,672,598,477,506,453,584,7952,8189,8675
E02005101,"Hever, Leigh & Penshurst",393,192,452,289,319,390,452,584,617,648,554,476,454,307,347,5889,6081,6474
E02006832,New Ash Green,311,117,424,322,389,436,375,357,375,400,369,413,439,298,231,4828,4945,5256
E02005102,"Lyminge, Densole & Elham",218,120,376,255,292,268,330,357,533,590,555,526,593,444,498,5617,5737,5955
E02005103,Hawkinge,630,279,809,559,689,645,712,758,804,723,544,421,566,409,448,8087,8366,8996
E02005104,Folkestone North East,468,200,647,485,503,513,486,519,630,633,523,450,501,316,402,6608,6808,7276
E02005105,Folkestone Foord,501,222,635,558,636,644,582,489,527,497,420,338,262,201,181,5970,6192,6693
E02005106,Cheriton & Horn Street,495,227,756,671,763,669,658,605,715,729,580,484,508,336,391,7865,8092,8587
E02005107,Folkestone Morehall & Sandgate,612,302,1324,970,928,930,931,899,990,981,820,778,907,635,777,11870,12172,12784
E02005109,"Saltwood, Seabrook & Etchinghill",279,136,386,194,205,275,352,405,476,565,576,563,645,558,807,6007,6143,6422
E02005110,Lympne & Palmarsh,296,142,462,351,387,398,377,378,591,659,590,518,568,470,491,6240,6382,6678
E02005111,Hythe,275,155,407,311,346,297,344,403,500,594,583,573,695,543,759,6355,6510,6785
E02005112,"Dymchurch, St Mary's Bay & Brookland",279,133,411,333,306,332,342,377,529,656,677,624,677,531,549,6344,6477,6756
E02005113,New Romney,306,119,468,355,372,326,300,375,511,616,615,577,665,537,667,6384,6503,6809
E02005114,Lydd & Dungeness,278,144,415,319,344,292,312,347,437,554,533,443,477,375,405,5253,5397,5675
E02006879,Folkestone Harbour,324,138,564,531,575,528,537,461,515,504,411,294,281,200,259,5660,5798,6122
E02006880,Folkestone Central,229,92,432,479,503,467,475,498,499,503,457,391,406,332,507,5949,6041,6270
E02005115,Sheerness East,385,193,572,517,594,562,432,355,451,425,369,254,198,130,150,5009,5202,5587
E02005116,Sheerness West,408,174,605,485,535,487,377,365,491,473,369,318,275,205,231,5216,5390,5798
E02005117,Minster North,263,127,425,382,431,359,358,390,471,597,536,481,561,423,410,5824,5951,6214
E02005118,Minster South,553,253,830,724,814,778,652,669,773,807,672,477,539,370,480,8585,8838,9391
E02005119,Queenborough,338,135,513,415,459,456,364,379,419,512,434,378,426,316,300,5371,5506,5844
E02005120,Sheppey East,347,160,905,947,925,861,702,610,788,872,694,629,654,409,383,9379,9539,9886
E02005121,Iwade & Kemsley,834,399,1120,957,1172,1132,1098,1077,1030,961,717,571,543,316,293,10987,11386,12220
E02005122,"Newington, Halstow & Upchurch",352,189,557,451,517,480,466,463,590,623,487,445,493,363,403,6338,6527,6879
E02005123,Borden & The Meads,693,305,1038,889,1002,939,955,864,917,782,712,553,612,429,514,10206,10511,11204
E02005124,Sittingbourne Central & Milton Regis,477,191,724,681,841,678,548,573,566,546,454,364,369,285,392,7021,7212,7689
E02005125,Sittingbourne East,488,185,582,580,666,643,604,534,525,522,475,396,389,256,314,6486,6671,7159
E02005126,Sittingbourne West,402,182,558,451,501,506,533,441,535,551,436,380,542,453,566,6453,6635,7037
E02005127,"Sittingbourne South, Bapchild & Bredgar",466,231,678,400,463,500,559,637,670,742,561,494,558,454,546,7262,7493,7959
E02005128,Faversham West,511,195,701,534,639,586,585,633,679,712,598,498,558,403,521,7647,7842,8353
E02005129,Faversham East,543,247,804,732,856,875,782,718,803,880,727,663,695,510,693,9738,9985,10528
E02005130,Teynham & Badlesmere,430,214,705,592,655,659,541,571,755,770,655,552,537,407,489,7888,8102,8532
E02005131,Boughton & Selling,293,142,627,518,483,525,516,572,615,525,481,386,426,322,314,6310,6452,6745
E02005132,Cliftonville West,611,278,1001,980,1081,1038,891,780,777,677,580,473,422,298,472,9470,9748,10359
E02005133,Cliftonville East & Kingsgate,337,174,529,416,457,429,467,495,568,684,704,670,833,669,788,7709,7883,8220
E02005134,Margate Town,422,175,697,666,773,677,570,568,597,558,459,334,302,199,185,6585,6760,7182
E02005135,Salmestone,430,188,654,539,650,611,532,474,544,536,425,411,334,283,332,6325,6513,6943
E02005136,Westbrook & Garlinge,421,188,586,450,489,502,455,485,597,612,562,510,522,394,457,6621,6809,7230
E02005137,Dane Valley & Northdown Hill,517,214,653,548,609,576,500,505,523,549,433,432,400,275,323,6326,6540,7057
E02005138,Westgate,412,182,586,542,602,547,500,516,655,663,629,604,664,523,705,7736,7918,8330
E02005139,Birchington,331,157,432,330,360,371,391,428,535,634,715,749,977,791,1082,7795,7952,8283
E02005140,Broadstairs North,338,190,457,315,326,345,396,452,542,609,558,501,683,568,732,6484,6674,7012
E02005141,Broadstairs South,323,168,415,315,379,406,392,445,516,562,528,560,585,423,523,6049,6217,6540
E02005142,"Westwood, Northwood & Bromstone",363,157,554,360,426,401,447,456,503,552,531,504,585,441,582,6342,6499,6862
E02005143,Dumpton,444,200,603,499,530,539,564,544,634,610,554,485,469,350,412,6793,6993,7437
E02005144,Newington,585,267,860,642,724,633,619,553,611,581,572,410,405,276,310,7196,7463,8048
E02005145,Minster & St-Nicholas-at-Wade,389,156,538,394,430,461,449,517,576,671,636,576,561,479,447,6735,6891,7280
E02005146,Ramsgate Ellington,578,289,684,510,585,612,534,570,623,507,441,369,353,227,239,6254,6543,7121
E02005147,Ramsgate Harbour,390,156,655,621,666,621,577,600,688,675,591,516,531,362,410,7513,7669,8059
E02005148,"Nethercourt, Pegwell & Cliffsend",333,161,436,337,403,424,439,471,575,657,595,635,684,566,660,6882,7043,7376
E02005149,"Aylesford, Wouldham & Blue Bell Hill",531,231,827,775,832,738,760,802,925,871,713,567,551,456,499,9316,9547,10078
E02005150,Snodland,549,253,818,764,947,887,825,767,815,820,655,550,512,371,417,9148,9401,9950
E02005151,Larkfield & New Hythe,659,287,878,807,908,848,855,848,977,929,794,707,658,568,621,10398,10685,11344
E02005153,Ditton,442,196,675,529,636,669,586,601,650,571,562,470,537,414,591,7491,7687,8129
E02005154,"Borough Green, Wrotham & Shipbourne",685,324,826,554,691,697,826,943,936,958,767,645,674,551,704,9772,10096,10781
E02005155,Kings Hill & Wateringbury,956,439,934,537,663,801,1023,1272,1144,950,689,518,549,417,394,9891,10330,11286
E02005156,Hadlow & East Peckham,338,209,569,408,373,335,424,410,585,618,481,447,495,392,469,6006,6215,6553
E02005157,Tonbridge Trench Wood,376,194,498,326,391,438,377,428,473,464,423,346,388,351,487,5390,5584,5960
E02005158,Hildenborough,397,185,429,294,322,352,442,542,553,595,396,371,424,316,435,5471,5656,6053
E02005159,Tonbridge Higham Wood,446,203,547,364,376,429,487,542,579,597,475,399,468,441,666,6370,6573,7019
E02005160,Tonbridge Town,816,439,858,934,1045,1043,998,913,878,792,620,415,465,385,631,9977,10416,11232
E02005161,Tonbridge South & Haysden,446,209,579,520,690,666,732,656,663,611,530,327,351,215,334,6874,7083,7529
E02006833,"East Malling, West Malling & Trottiscliffe",587,244,766,722,838,821,838,890,913,1002,845,702,741,539,674,10291,10535,11122
E02005162,Paddock Wood & Five Oak Green,518,259,806,646,646,647,660,797,852,791,668,607,611,509,585,8825,9084,9602
E02005163,Southborough West,567,249,598,382,457,504,648,660,712,633,441,344,386,278,365,6408,6657,7224
E02005164,Southborough East & Longfield Road,532,232,589,578,732,747,762,700,637,557,415,353,366,290,410,7136,7368,7900
E02005165,Pembury & Matfield,416,187,498,385,391,439,468,530,571,622,520,439,504,422,524,6313,6500,6916
E02005166,High Brooms & Sherwood,441,188,529,486,575,609,545,519,486,447,373,277,261,188,233,5528,5716,6157
E02005167,"Langton Green, Speldhurst & Bidborough",468,201,517,286,331,427,544,609,630,604,496,435,518,359,515,6271,6472,6940
E02005168,Tunbridge Wells West,494,226,431,419,502,577,620,719,662,542,444,318,325,242,536,6337,6563,7057
E02005169,Tunbridge Wells Central,385,146,645,906,1196,1044,862,720,670,581,455,317,346,222,293,8257,8403,8788
E02005170,Ferndale & Hawkenbury,517,236,642,580,749,786,821,741,755,671,464,388,399,358,667,8021,8257,8774
E02005171,Ramslye & Rusthall,340,147,425,403,470,477,476,467,468,427,334,264,286,220,323,5040,5187,5527
E02005172,"Goudhurst, Horsmonden & Lamberhurst",514,233,696,396,376,489,542,645,740,794,642,508,482,413,418,7141,7374,7888
E02005173,Tunbridge Wells South,426,188,481,435,538,645,654,676,697,653,580,469,482,410,598,7318,7506,7932
E02005174,"Cranbrook, Sissinghurst & Frittenden",607,320,694,374,403,395,419,515,618,629,523,452,485,402,583,6492,6812,7419
E02005175,"Hawkhurst, Benenden & Sandhurst",714,409,586,373,467,426,469,550,728,701,623,563,543,460,552,7041,7450,8164
E02005921,"Cropredy, Wroxton & Shennington",264,126,376,366,453,467,429,416,559,620,565,454,420,326,404,5855,5981,6245
E02005922,Banbury Hardwick,430,208,689,671,803,755,688,629,662,669,449,347,317,213,204,7096,7304,7734
E02005923,Banbury Neithrop,364,153,498,482,572,545,513,472,483,412,276,248,221,176,232,5130,5283,5647
E02005924,Banbury Grimsbury,529,225,1144,1460,1572,1365,1072,968,849,776,609,415,352,244,468,11294,11519,12048
E02005925,Banbury Ruscote,624,251,816,642,701,775,725,578,678,562,436,350,369,254,308,7194,7445,8069
E02005926,Banbury Easington,481,248,668,538,583,633,563,584,669,679,593,504,574,499,750,7837,8085,8566
E02005927,Banbury Calthorpe,235,99,390,437,467,481,441,388,390,429,308,263,368,247,252,4861,4960,5195
E02005928,"Bodicote, Adderbury & Bloxham",627,317,693,642,737,770,774,771,832,745,561,522,646,489,593,8775,9092,9719
E02005929,"Sibford, Hook Norton & Milcombe",425,223,496,321,392,434,481,498,616,682,601,495,572,369,415,6372,6595,7020
E02005930,"Deddington, Steeple Aston & Heyfords",457,224,553,428,600,650,633,661,763,750,589,527,532,369,495,7550,7774,8231
E02005931,"Caversfield, Ambrosden & Fringford",565,241,681,718,841,883,817,751,796,788,661,491,429,308,422,8586,8827,9392
E02005932,Bicester North,394,180,555,507,559,548,556,599,570,518,331,253,212,137,105,5450,5630,6024
E02005933,Bicester East,392,172,600,570,682,671,630,554,616,550,485,400,358,264,289,6669,6841,7233
E02005934,Bicester West,428,215,653,607,727,771,650,577,666,694,662,513,458,349,479,7806,8021,8449
E02005935,Bicester South,410,208,681,775,980,846,704,710,682,570,387,327,246,213,366,7487,7695,8105
E02005936,"Islip, Arncott & Chesterton",574,294,1272,1161,1419,1440,1244,1000,970,1019,809,622,577,442,512,12487,12781,13355
E02005937,Kidlington North,275,149,457,447,526,531,507,478,473,546,494,391,449,347,581,6227,6376,6651
E02005938,Kidlington South,279,139,429,430,504,547,436,379,375,430,385,327,281,191,311,5025,5164,5443
E02005939,"Begbroke, Yarnton & Water Eaton",327,164,493,628,659,643,518,416,484,555,453,405,393,271,469,6387,6551,6878
E02005940,Wolvercote & Cutteslowe,429,170,443,411,446,466,515,499,549,535,422,359,368,269,412,5694,5864,6293
E02005941,Summertown,801,560,841,593,664,608,646,579,558,513,429,352,385,263,395,6826,7386,8187
E02005942,North Central Oxford,427,371,1797,949,767,596,559,532,485,531,370,304,320,276,335,7821,8192,8619
E02005943,Marston,433,228,603,597,624,670,633,568,520,458,338,271,302,229,389,6202,6430,6863
E02005944,Barton,544,236,860,816,1004,951,682,643,589,513,432,278,250,179,240,7437,7673,8217
E02005945,Headington,648,800,8189,2142,1573,1182,919,790,688,594,506,398,371,324,449,18125,18925,19573
E02005946,Risinghurst & Sandhills,420,212,716,826,915,905,816,706,645,564,451,383,375,286,355,7943,8155,8575
E02005947,Oxford Central,282,708,16416,7563,3847,1670,855,569,484,454,338,293,199,181,192,33061,33769,34051
E02005948,"Osney, Jericho & Port Meadow",209,134,1198,1155,1089,813,573,427,408,384,289,248,209,163,184,7140,7274,7483
E02005949,Churchill,330,166,1855,1072,1068,811,618,501,412,332,271,222,181,115,211,7669,7835,8165
E02005950,East Central Oxford,319,316,2891,1656,1529,1124,795,577,510,445,432,354,315,193,214,11035,11351,11670
E02005951,Grandpont & New Hinksey,262,120,537,735,725,640,584,419,401,389,278,244,218,146,229,5545,5665,5927
E02005952,Cowley North,671,334,2645,2065,2269,1868,1490,1123,947,829,641,489,371,262,380,15379,15713,16384
E02005953,Iffley Fields,223,112,637,713,785,696,530,408,378,359,281,242,210,108,132,5479,5591,5814
E02005954,Cowley South & Iffley,433,244,1027,997,1248,1177,1049,782,760,677,571,429,378,310,486,9891,10135,10568
E02005955,Littlemore & Rose Hill,644,282,961,1060,1202,1181,966,808,776,738,517,409,360,230,344,9552,9834,10478
E02005956,Blackbird Leys,395,213,630,572,644,609,526,521,511,517,352,250,192,168,251,5743,5956,6351
E02005957,Greater Leys,403,189,666,623,655,636,602,555,534,466,325,212,144,119,186,5723,5912,6315
E02005958,Thame North,224,118,373,289,387,348,361,354,405,479,396,336,306,218,256,4508,4626,4850
E02005959,Beckley & Horspath,272,129,393,404,401,363,371,385,440,516,470,391,372,289,322,5117,5246,5518
E02005960,Thame South,449,187,493,417,479,512,587,600,564,524,383,370,446,368,568,6311,6498,6947
E02005961,Wheatley & Great Haseley,316,156,465,447,487,475,462,465,572,619,461,413,452,360,470,6148,6304,6620
E02005962,Chinnor & Tetsworth,442,206,620,519,683,726,638,676,751,743,652,614,630,481,500,8233,8439,8881
E02005963,Berinsfield & Wittenham,382,174,595,421,520,553,549,542,644,693,621,558,448,398,484,7026,7200,7582
E02005964,"Chalgrove, Stadhampton & Dorchester",283,165,477,369,425,425,438,475,638,643,585,468,473,398,495,6309,6474,6757
E02005965,Watlington & Nettlebed,285,120,378,229,273,282,349,431,502,508,452,326,324,299,370,4723,4843,5128
E02005966,Didcot Ladygrove,420,202,591,638,712,793,697,661,695,585,419,264,208,102,114,6479,6681,7101
E02005967,Didcot West,451,167,632,731,968,923,755,574,558,506,367,301,308,258,364,7245,7412,7863
E02005968,Benson & Crowmarsh Gifford,356,142,742,759,778,755,714,576,550,525,444,355,364,334,409,7305,7447,7803
E02005969,Wallingford & Brightwell,495,211,632,523,623,672,639,772,798,702,574,534,527,439,689,8124,8335,8830
E02005970,Didcot South East,229,127,399,517,564,505,439,355,458,435,338,256,179,129,134,4708,4835,5064
E02005971,Didcot South West,309,159,442,431,517,452,419,424,451,490,368,301,287,257,349,5188,5347,5656
E02005972,"Hagbourne, Moreton & Cholsey",603,258,683,798,980,925,851,848,829,736,600,543,551,438,578,9360,9618,10221
E02005973,Henley North,238,129,400,376,439,450,436,457,456,478,410,300,384,384,577,5547,5676,5914
E02005974,Henley South,320,160,501,371,384,397,464,532,573,515,425,313,322,347,522,5666,5826,6146
E02005975,"Goring, Woodcote & Whitchurch",562,274,622,358,375,409,504,632,746,677,581,505,597,447,581,7034,7308,7870
E02005976,Shiplake & Binfield Heath,394,270,547,288,265,285,375,516,624,620,500,402,402,363,392,5579,5849,6243
E02005977,Sonning Common & Kidmore End,296,146,376,259,285,337,387,464,511,525,398,356,387,324,556,5165,5311,5607
E02005978,"Dean Court, Cumnor & Appleton",384,200,573,480,462,509,541,530,621,610,522,457,494,370,597,6766,6966,7350
E02005979,Botley & Kennington,529,240,813,797,813,792,833,738,754,747,667,490,477,391,665,8977,9217,9746
E02005980,"Radley, Wootton & Marcham",1007,533,850,689,773,812,749,763,783,783,729,592,634,499,697,9353,9886,10893
E02005981,Abingdon Northcourt & Peachcroft,407,195,530,535,633,641,642,615,651,688,677,555,550,345,344,7406,7601,8008
E02005982,Abingdon Audlett Drive & Farm Road,285,124,354,380,368,414,469,488,432,443,376,320,310,286,316,4956,5080,5365
E02005983,Abingdon Town & West,578,271,854,912,1007,1006,936,856,843,723,640,485,517,380,721,9880,10151,10729
E02005984,Kingston Bagpuize & East Hanney,438,229,593,443,572,641,561,642,737,795,648,529,540,396,428,7525,7754,8192
E02005985,Abingdon South,395,189,624,545,623,648,575,567,606,553,471,434,459,365,435,6905,7094,7489
E02005986,Faringdon & Stanford,469,213,578,536,637,656,684,668,732,747,603,506,561,400,553,7861,8074,8543
E02005987,"Sutton Courtenay, Drayton & Steventon",506,246,665,608,757,829,765,721,727,693,630,510,493,351,481,8230,8476,8982
E02005988,Grove,425,199,558,658,800,724,570,556,527,628,515,476,431,333,399,7175,7374,7799
E02005991,Wantage Town,450,233,745,644,785,711,678,643,805,715,608,531,577,427,744,8613,8846,9296
E02005992,"South Wantage, Harwell & Blewbury",722,283,886,863,1112,1140,1046,917,962,923,815,645,637,491,703,11140,11423,12145
E02006886,"Shrivenham, Watchfield & Uffington",712,312,915,805,1147,1151,1094,1104,1175,1118,881,689,760,615,733,12187,12499,13211
E02005993,Chipping Norton,327,145,457,454,496,482,473,480,561,538,423,420,480,407,571,6242,6387,6714
E02005994,"Kingham, Enstone & Middle Barton",365,186,456,292,332,387,393,458,504,537,463,381,414,302,331,5250,5436,5801
E02005995,Chadlington & Wychwoods,300,141,421,257,303,335,394,471,531,560,536,482,481,386,490,5647,5788,6088
E02005996,"Woodstock, Stonesfield & Tackley",470,203,568,397,494,534,608,701,784,675,589,522,519,449,620,7460,7663,8133
E02005997,Charlbury & North Leigh,278,123,352,305,328,319,371,376,426,497,505,453,461,303,401,5097,5220,5498
E02005998,Hanborough & Cassington,349,143,399,379,419,439,474,496,511,544,446,428,467,388,520,5910,6053,6402
E02005999,"Leafield, Minster Lovell & Duckington",316,157,439,356,361,353,401,433,531,650,489,420,468,344,440,5685,5842,6158
E02006000,Witney East,620,325,815,664,741,843,877,910,857,923,727,591,636,486,621,9691,10016,10636
E02006001,Witney West,364,150,531,563,602,601,526,416,497,481,378,282,289,166,420,5752,5902,6266
E02006002,Witney Central,433,226,850,877,928,795,730,678,766,747,599,560,595,487,785,9397,9623,10056
E02006003,Eynsham & Stanton Harcourt,316,134,430,338,396,355,340,441,522,509,426,350,351,346,381,5185,5319,5635
E02006004,Burford & Brize Norton,317,150,1117,1087,1127,962,860,618,659,589,548,392,439,312,404,9114,9264,9581
E02006005,Carterton North,499,212,618,701,868,725,664,555,617,548,444,293,260,211,247,6751,6963,7462
E02006006,Carterton South,231,110,345,320,335,335,329,347,377,427,398,320,276,229,311,4349,4459,4690
E02006007,"Bampton, Clanfield & Standlake",358,163,490,361,422,429,444,479,594,597,565,461,501,371,479,6193,6356,6714
E02006317,West Molesey North,313,161,401,333,398,468,518,571,469,464,393,353,352,271,378,5369,5530,5843
E02006318,East Molesey,361,172,433,424,465,541,606,623,627,616,481,425,382,309,364,6296,6468,6829
E02006319,West Molesey South,383,177,495,398,566,614,684,597,553,537,429,334,321,225,320,6073,6250,6633
E02006320,Walton North & Molesey Heath,344,126,438,470,685,685,608,532,562,506,375,285,248,189,242,5825,5951,6295
E02006321,Thames Ditton,422,190,445,312,389,453,630,663,595,507,381,308,295,227,386,5591,5781,6203
E02006322,Long Ditton,459,215,464,364,418,519,678,682,596,518,388,328,272,201,270,5698,5913,6372
E02006323,Walton Central,328,155,451,478,508,632,666,621,606,513,452,361,337,284,500,6409,6564,6892
E02006324,Walton East,458,210,582,443,598,709,736,679,631,559,416,319,272,221,310,6475,6685,7143
E02006325,Hinchley Wood & Weston Green,700,336,755,499,471,645,876,946,906,744,600,414,416,301,456,8029,8365,9065
E02006326,Walton Hersham Road,398,152,464,443,613,683,723,663,530,477,377,333,340,244,349,6239,6391,6789
E02006327,Oatlands,425,191,403,309,323,475,619,666,575,517,418,297,345,321,489,5757,5948,6373
E02006328,Weybridge Riverside,551,234,613,554,686,787,924,957,808,798,564,435,413,342,512,8393,8627,9178
E02006329,Esher,566,245,716,485,458,494,622,725,735,676,542,368,415,313,448,6997,7242,7808
E02006330,Hersham,530,255,719,531,633,762,904,829,774,689,538,468,490,416,636,8389,8644,9174
E02006331,Claygate,473,222,511,333,396,486,603,650,649,631,520,391,393,304,457,6324,6546,7019
E02006332,Weybridge St George's Hill,439,222,536,383,372,456,614,649,643,600,506,329,317,232,408,6045,6267,6706
E02006333,Cobham,839,480,1102,602,586,622,856,955,997,863,658,502,481,405,619,9248,9728,10567
E02006334,Oxshott & Stoke D'Abernon,677,309,785,413,402,516,760,830,902,745,660,472,448,363,522,7818,8127,8804
E02006335,Worcester Park West,364,181,581,430,544,557,662,591,612,624,613,451,453,393,519,7030,7211,7575
E02006336,Ruxley Lane,409,200,555,485,523,602,612,554,531,547,409,322,321,195,259,5915,6115,6524
E02006337,Stoneleigh & Auriol,451,226,657,475,531,651,708,701,727,670,569,470,526,387,530,7602,7828,8279
E02006338,West Ewell,350,160,498,349,437,542,534,554,541,532,376,378,405,313,324,5783,5943,6293
E02006339,Horton & Manor Park,681,307,829,589,763,1025,1091,1014,859,677,529,410,379,271,280,8716,9023,9704
E02006341,Epsom North,544,261,865,737,767,813,869,845,794,707,597,437,440,347,532,8750,9011,9555
E02006342,Epsom Town,360,155,884,710,740,740,737,646,540,474,373,325,385,289,574,7417,7572,7932
E02006343,Epsom Downs & Common,649,367,682,429,464,576,757,771,741,687,548,465,432,334,474,7360,7727,8376
E02006837,Ewell East,654,321,878,648,672,720,936,958,892,937,715,574,645,554,728,9857,10178,10832
E02006344,West Clandon & Send,413,215,586,381,468,474,567,662,676,768,630,535,526,465,571,7309,7524,7937
E02006345,Pirbright & Normandy,272,260,956,671,619,485,446,465,512,487,378,331,355,284,333,6322,6582,6854
E02006346,Horsley & Effingham,720,336,858,474,384,490,652,780,861,921,756,552,679,536,760,8703,9039,9759
E02006347,Ash Vale,290,137,458,389,516,524,528,551,558,441,434,344,401,280,403,5827,5964,6254
E02006348,"Worplesdon, Jacobs Well & Wood Street",371,205,621,544,666,661,621,630,602,632,565,462,470,403,598,7475,7680,8051
E02006349,Stoughton,385,144,922,658,716,725,716,584,529,516,368,356,320,199,330,6939,7083,7468
E02006350,"Bellfields, Slyfield & Weyfield",343,173,697,532,634,627,567,492,438,450,355,244,247,158,207,5648,5821,6164
E02006351,Burpham North & Merrow East,567,235,607,503,532,597,694,727,666,647,501,368,393,229,378,6842,7077,7644
E02006352,Woodbridge Hill,267,96,876,535,544,471,451,417,396,359,320,269,247,189,215,5289,5385,5652
E02006353,Ash Wharf,281,133,468,362,440,447,423,452,439,466,356,276,304,249,316,4998,5131,5412
E02006354,"Burpham, Boxgrove & Merrow West",636,329,681,458,441,517,811,859,825,769,572,465,455,403,658,7914,8243,8879
E02006355,Park Barn & Royal Surrey,337,156,3200,1067,799,593,392,451,420,369,306,234,164,118,201,8314,8470,8807
E02006356,Guildford Town Centre,409,187,1504,1506,1480,1317,1117,1010,805,680,521,380,291,257,398,11266,11453,11862
E02006357,Tongham,305,131,456,431,574,545,504,465,545,547,494,437,383,274,303,5958,6089,6394
E02006358,Onslow Village and University,300,209,3824,1239,704,612,578,496,428,371,275,255,243,172,234,9431,9640,9940
E02006359,Pewley Down & The Mount,356,152,462,419,398,432,474,485,510,497,420,334,362,213,325,5331,5483,5839
E02006360,Shalford & Wanborough,440,222,531,379,414,486,586,651,698,733,568,458,416,398,675,6993,7215,7655
E02006361,"Gomshall, Shere & Albury",305,155,394,246,277,265,335,439,503,597,476,426,430,303,368,5059,5214,5519
E02006362,Ashtead East,417,228,551,319,295,382,507,566,606,541,455,391,408,352,551,5924,6152,6569
E02006363,Ashtead West,384,181,429,250,277,366,434,503,544,441,432,381,342,305,412,5116,5297,5681
E02006364,Leatherhead North,351,170,613,677,756,727,635,540,550,513,384,312,305,224,350,6586,6756,7107
E02006365,Leatherhead South & Ashtead South,284,143,472,355,363,392,458,461,494,509,433,386,365,343,568,5599,5742,6026
E02006366,Fetcham,402,218,636,367,414,485,538,561,613,665,582,542,522,438,554,6917,7135,7537
E02006367,Bookham North,296,151,425,294,246,295,378,399,484,480,428,349,385,378,550,5091,5242,5538
E02006368,Bookham South,321,151,396,259,228,278,376,386,470,468,436,391,396,340,520,4944,5095,5416
E02006369,Box Hill & Brockham,240,129,417,274,267,289,360,442,468,645,574,524,484,442,591,5777,5906,6146
E02006370,Dorking North & Westhumble,328,179,431,372,406,390,460,541,539,523,443,344,373,288,396,5506,5685,6013
E02006371,Dorking South,351,160,515,453,425,503,563,604,605,593,508,451,410,352,523,6505,6665,7016
E02006372,Holmwoods,342,170,491,402,460,435,449,471,514,532,403,340,294,244,358,5393,5563,5905
E02006373,"Westcott, Ockley & Capel",394,180,603,372,400,403,497,590,689,775,608,437,480,365,468,6687,6867,7261
E02006374,"Charlwood, Newdigate & Beare Green",330,162,577,451,459,458,446,499,651,707,584,484,482,377,424,6599,6761,7091
E02006375,Nork,343,151,475,326,346,467,540,475,502,551,468,359,402,298,407,5616,5767,6110
E02006376,Banstead,406,160,712,686,710,699,715,600,654,657,580,465,532,458,808,8276,8436,8842
E02006377,Tattenham North,314,156,499,312,341,317,428,468,449,564,434,392,427,340,452,5423,5579,5893
E02006378,Chipstead & Netherne,491,232,677,457,468,564,627,671,713,793,613,431,453,321,436,7224,7456,7947
E02006379,Tattenham South,386,183,505,429,595,593,551,507,449,428,365,285,238,170,230,5345,5528,5914
E02006380,Tadworth & Walton,347,156,508,363,388,392,425,484,520,660,582,468,492,431,578,6291,6447,6794
E02006381,Kingswood,352,171,508,399,379,408,442,487,583,640,608,419,451,367,493,6184,6355,6707
E02006382,Merstham,385,195,494,502,675,621,566,518,520,459,340,272,280,170,240,5657,5852,6237
E02006383,Reigate Hill & Gatton,721,378,682,528,651,738,778,774,829,744,521,452,474,429,771,8371,8749,9470
E02006384,Redhill West,662,258,756,786,1047,1104,952,907,863,727,575,421,424,349,498,9409,9667,10329
E02006385,Redhill East,551,249,717,932,1397,1345,1160,932,770,672,529,348,321,233,330,9686,9935,10486
E02006386,Reigate Central & Redhill Common,524,235,529,441,502,581,754,734,711,601,430,367,352,281,395,6678,6913,7437
E02006387,Reigate South Park,430,200,472,379,400,491,565,514,562,525,403,279,331,219,268,5408,5608,6038
E02006388,Earlswood & Whitebushes,445,199,670,632,946,856,814,784,727,641,494,387,418,269,325,7963,8162,8607
E02006389,Salfords & Woodhatch,404,163,501,367,467,530,597,506,555,562,443,374,389,266,371,5928,6091,6495
E02006390,Horley West,518,228,636,707,949,918,830,694,647,628,533,452,459,319,410,8182,8410,8928
E02006391,Horley East,394,137,508,478,601,701,709,588,570,525,528,384,353,223,267,6435,6572,6966
E02006392,Horley Central,392,156,646,727,855,839,793,704,673,678,527,446,427,310,545,8170,8326,8718
E02006393,Egham Town,208,103,1133,680,559,558,461,401,399,371,307,223,187,174,352,5805,5908,6116
E02006394,Englefield Green & University,488,204,4522,1393,683,609,592,591,593,559,464,356,357,272,456,11447,11651,12139
E02006395,Egham Hythe & Pooley Green,466,224,758,684,828,859,812,745,730,716,590,445,404,227,392,8190,8414,8880
E02006396,Thorpe,348,255,416,309,388,393,381,431,473,524,432,386,402,324,397,5256,5511,5859
E02006397,Virginia Water,414,196,579,365,356,438,510,586,602,600,490,369,300,289,450,5934,6130,6544
E02006398,Chertsey,391,160,598,678,776,706,676,709,649,612,539,358,359,305,363,7328,7488,7879
E02006399,Addlestone North,629,242,899,813,980,1082,960,937,895,890,723,584,510,463,651,10387,10629,11258
E02006400,Ottershaw & Lyne,281,123,372,375,445,375,397,475,485,525,427,348,344,262,406,5236,5359,5640
E02006401,Addlestone South,527,260,736,680,813,784,827,806,802,767,576,463,452,417,576,8699,8959,9486
E02006402,New Haw & Woodham,476,236,738,561,653,698,804,794,813,800,648,516,555,430,579,8589,8825,9301
E02006403,Stanwell North & Stanwell Moor,316,134,482,465,655,670,630,475,503,490,396,288,264,182,253,5753,5887,6203
E02006404,Stanwell South,501,214,653,662,765,754,735,624,581,508,392,290,216,177,299,6656,6870,7371
E02006405,Ashford West,493,229,951,864,1107,1175,1083,924,841,862,719,500,550,392,548,10516,10745,11238
E02006406,Staines Town,366,180,690,874,1156,1037,840,743,676,680,494,344,326,245,323,8428,8608,8974
E02006407,Ashford East,452,218,669,621,726,758,689,615,750,747,583,444,444,393,552,7991,8209,8661
E02006408,Ashford Common,401,185,600,625,743,709,685,612,650,666,478,387,330,318,450,7253,7438,7839
E02006409,Staines South East,392,174,551,469,478,539,534,511,553,524,431,344,319,236,307,5796,5970,6362
E02006410,Sunbury Common,496,218,639,608,749,676,672,675,598,622,479,347,314,211,343,6933,7151,7647
E02006411,Staines South West,332,175,496,380,504,573,560,533,612,562,458,414,392,348,555,6387,6562,6894
E02006412,Sunbury East,413,179,468,395,484,540,612,538,598,606,450,410,430,348,489,6368,6547,6960
E02006413,Halliford & Sunbury West,299,146,493,334,389,385,507,441,497,503,432,368,364,282,488,5483,5629,5928
E02006414,Littleton & Shepperton Green,292,137,413,299,420,408,399,436,484,522,456,350,341,275,379,5182,5319,5611
E02006415,Shepperton Town,278,141,393,353,345,396,450,422,562,577,496,425,461,440,697,6017,6158,6436
E02006416,Chobham & Windlesham,376,174,579,395,455,497,575,620,661,767,715,516,525,400,549,7254,7428,7804
E02006417,Bagshot,298,124,394,382,439,513,512,476,485,505,395,313,315,241,332,5302,5426,5724
E02006418,Lightwater,295,134,488,330,368,339,417,460,584,602,484,390,401,344,505,5712,5846,6141
E02006419,Camberley North,436,223,698,602,665,610,643,600,660,603,480,346,272,209,415,6803,7026,7462
E02006420,Camberley Town,405,230,679,517,450,453,523,649,637,667,521,446,447,385,633,7007,7237,7642
E02006421,West End & Bisley,711,350,735,600,687,745,757,766,816,758,587,436,446,340,547,8220,8570,9281
E02006422,Camberley Heatherside,389,177,472,331,332,401,502,510,521,460,388,332,354,284,294,5181,5358,5747
E02006423,Camberley West,548,254,922,922,1102,931,915,896,881,876,646,519,461,406,620,10097,10351,10899
E02006424,Camberley Parkside,366,192,482,315,336,407,503,511,531,520,388,371,403,318,439,5524,5716,6082
E02006425,Frimley,387,163,481,454,525,501,462,574,530,473,405,301,308,262,340,5616,5779,6166
E02006426,Frimley Green,269,124,400,301,351,380,435,396,435,434,357,324,320,286,347,4766,4890,5159
E02006427,Mytchett & Frith Hill,312,146,436,369,495,507,428,475,529,461,389,333,328,282,344,5376,5522,5834
E02006429,Warlingham West & Whyteleafe,388,155,536,540,651,684,607,610,608,576,515,394,365,331,351,6768,6923,7311
E02006430,Caterham North,554,245,737,543,724,720,764,732,777,677,510,423,428,299,431,7765,8010,8564
E02006431,Caterham Valley,738,380,794,656,792,883,848,826,846,818,706,582,559,392,565,9267,9647,10385
E02006432,Caterham West,276,136,433,288,348,334,416,371,472,522,384,318,347,293,390,4916,5052,5328
E02006433,Oxted North,459,222,658,457,466,581,754,704,716,732,627,529,566,475,768,8033,8255,8714
E02006434,Oxted South,376,168,483,375,387,447,467,445,539,431,389,328,312,246,361,5210,5378,5754
E02006435,Nutfield & Bletchingley,279,132,411,318,370,377,394,445,468,530,449,373,345,256,295,5031,5163,5442
E02006436,Godstone,327,161,472,293,413,435,386,450,522,476,410,325,322,261,355,5120,5281,5608
E02006437,Lingfield & Dormansland,412,234,636,366,447,474,505,561,669,717,601,525,526,425,635,7087,7321,7733
E02006438,Smallfield & Felbridge,454,211,621,470,509,497,515,647,763,780,638,547,575,451,505,7518,7729,8183
E02006790,Warlingham East & Tatsfield,368,180,552,386,449,484,520,472,574,624,575,456,495,394,610,6591,6771,7139
E02006439,Farnham Weybourne & Badshot Lea,309,143,437,354,379,412,418,468,510,506,386,330,363,282,372,5217,5360,5669
E02006440,Farnham Upper Hale,369,190,606,376,421,473,540,578,582,537,423,398,408,331,380,6053,6243,6612
E02006441,Farnham Town,345,182,1254,619,638,609,535,555,639,530,481,369,382,370,663,7644,7826,8171
E02006442,Farnham Moor Park & Bourne,435,178,464,254,252,332,496,540,586,464,377,337,373,302,482,5259,5437,5872
E02006443,Farncombe,292,128,433,454,616,640,597,523,531,496,470,393,343,321,452,6269,6397,6689
E02006444,Farnham Shortheath,486,206,489,333,352,463,582,617,585,477,420,315,367,270,376,5646,5852,6338
E02006445,Godalming North,633,533,466,501,655,719,669,660,548,498,456,336,354,321,438,6621,7154,7787
E02006446,"Blackheath, Wonersh & Shamley Green",438,215,465,277,331,369,468,564,586,608,477,395,379,363,464,5746,5961,6399
E02006447,Farnham Wrecclesham,463,206,468,272,339,400,496,521,573,483,364,382,359,323,369,5349,5555,6018
E02006448,Godalming South,402,189,407,353,460,599,629,592,605,500,484,358,384,275,372,6018,6207,6609
E02006449,Elstead & Milford,341,170,489,347,380,426,486,551,524,609,507,360,420,345,603,6047,6217,6558
E02006450,"Wheelerstreet, Wormley & Hambledon",461,271,594,387,405,454,514,641,694,603,516,435,402,309,425,6379,6650,7111
E02006451,Cranleigh,825,456,871,663,716,722,737,792,862,836,767,745,837,736,863,10147,10603,11428
E02006453,Ewhurst & Chiddingfold,389,427,896,413,426,504,529,604,685,703,598,502,583,520,756,7719,8146,8535
E02006454,Haslemere East,397,159,407,262,290,430,503,555,610,484,425,360,371,283,594,5574,5733,6130
E02006455,Haslemere West,323,142,474,298,363,391,469,547,477,468,373,304,267,244,367,5042,5184,5507
E02006839,"Hindhead, Beacon Hill & Frensham",428,208,564,342,381,451,532,664,759,740,627,506,539,441,732,7278,7486,7914
E02006456,Byfleet,399,179,547,462,630,649,706,629,609,597,422,361,375,286,458,6731,6910,7309
E02006457,West Byfleet & Pyrford North,525,241,667,475,532,638,751,833,801,712,627,509,548,461,760,8314,8555,9080
E02006458,Horsell,544,247,662,549,495,592,716,845,710,725,544,496,511,378,618,7841,8088,8632
E02006459,Sheerwater,645,287,1202,1172,1294,1222,1149,889,772,569,497,387,272,157,327,9909,10196,10841
E02006460,Goldsworth Park,488,190,600,642,772,864,847,658,556,648,583,504,458,268,322,7722,7912,8400
E02006461,Maybury Hill & Pyrford South,395,184,512,447,515,554,608,595,540,534,423,385,363,293,440,6209,6393,6788
E02006462,Knaphill,477,204,594,558,603,687,664,709,668,642,468,374,371,284,324,6946,7150,7627
E02006463,Woking Central,405,154,719,1127,1433,1415,1239,885,733,631,467,353,332,268,431,10033,10187,10592
E02006464,St John's,358,164,460,404,438,540,529,567,562,494,425,338,343,254,386,5740,5904,6262
E02006465,Hook Heath,316,152,419,358,402,496,530,474,510,464,418,345,346,239,368,5369,5521,5837
E02006466,Old Woking & Westfield,749,330,826,738,940,989,1101,926,819,680,509,387,362,263,391,8931,9261,10010
E02006467,Mayford & Brookwood,436,207,495,382,497,580,591,620,583,570,498,348,342,269,330,6105,6312,6748
E02006534,Hillside,446,220,664,453,590,637,634,653,686,707,547,488,486,410,579,7534,7754,8200
E02006535,Buckingham,360,148,403,335,365,463,530,581,545,503,476,432,551,409,510,6103,6251,6611
E02006536,North Lancing,509,283,493,357,400,478,497,472,555,551,485,435,464,341,461,5989,6272,6781
E02006537,Kingston & Southwick,528,244,750,661,770,736,793,763,787,765,601,496,524,390,638,8674,8918,9446
E02006538,Shoreham Central & Beach,401,148,507,468,501,547,665,759,767,715,617,577,623,468,604,7818,7966,8367
E02006539,Cokeham & Sompting,325,164,480,416,478,477,469,470,532,539,444,423,469,416,510,6123,6287,6612
E02006540,Marsh Barn & Widewater,232,108,351,332,392,323,319,380,437,421,438,365,384,340,433,4915,5023,5255
E02006541,South Lancing,281,148,453,438,510,520,494,443,554,540,518,449,533,455,684,6591,6739,7020
E02006542,Arundel,223,125,352,254,232,276,294,338,474,558,491,472,478,427,485,5131,5256,5479
E02006543,"Angmering North, Patching & Findon",245,105,359,246,290,283,312,318,432,514,481,414,452,391,429,4921,5026,5271
E02006544,"Westergate, Eastergate & Walberton",519,269,751,559,666,651,635,742,890,963,828,768,813,614,891,9771,10040,10559
E02006545,Wick & Toddington,641,259,859,825,993,964,819,668,792,749,625,519,502,350,368,9033,9292,9933
E02006546,Angmering South,510,277,722,523,635,638,630,719,841,803,665,653,811,646,953,9239,9516,10026
E02006547,Yapton & Climping,287,147,434,438,541,478,442,381,502,509,496,485,455,334,381,5876,6023,6310
E02006548,Rustington North,459,184,661,528,658,635,610,617,685,760,688,552,589,532,727,8242,8426,8885
E02006549,Ferring & Kingston Gorse,182,75,264,170,177,190,212,293,408,510,518,554,758,659,903,5616,5691,5873
E02006550,Littlehampton East,383,192,651,458,523,479,499,504,714,706,664,718,834,655,963,8368,8560,8943
E02006551,East Preston & Rustington East,154,93,283,217,215,203,247,323,451,548,637,782,1081,949,1297,7233,7326,7480
E02006552,Littlehampton West and River,277,110,532,541,641,523,548,505,578,624,511,423,435,298,468,6627,6737,7014
E02006553,North Bersted,422,184,664,638,774,826,664,579,706,678,664,598,558,400,538,8287,8471,8893
E02006554,Middleton-on-Sea,256,145,400,308,329,303,312,398,477,525,538,559,633,523,639,5944,6089,6345
E02006555,South Bersted,399,176,649,552,640,625,572,483,627,582,475,432,349,296,419,6701,6877,7276
E02006556,Felpham,524,213,681,531,556,536,596,576,770,795,683,710,885,747,921,8987,9200,9724
E02006557,Hawthorn Road,426,187,708,650,701,644,567,596,665,622,483,322,340,241,310,6849,7036,7462
E02006558,Bognor Regis Central,326,142,984,935,1094,924,789,771,836,827,700,583,600,507,834,10384,10526,10852
E02006559,Aldwick,273,134,364,289,314,329,336,424,472,627,741,703,1002,821,1139,7561,7695,7968
E02006560,Nyetimber & Pagham,334,174,513,427,456,479,459,532,635,786,733,707,906,777,974,8384,8558,8892
E02006561,Fernhurst & Northchapel,410,154,391,281,285,345,470,577,544,576,521,379,451,345,375,5540,5694,6104
E02006562,Ifold & Wisborough Green,329,161,395,264,261,290,367,438,552,582,556,443,435,376,373,5332,5493,5822
E02006563,Millland & South Harting,282,139,403,280,267,279,322,410,558,587,504,445,413,329,416,5213,5352,5634
E02006564,Midhurst & Cocking,349,142,469,379,511,456,427,505,591,655,571,604,636,500,723,7027,7169,7518
E02006565,Easebourne & Petworth,358,158,524,343,401,386,435,529,607,718,644,598,642,537,714,7078,7236,7594
E02006566,"Dean, Lavant & Summersdale",330,151,533,420,409,413,429,475,572,660,697,582,649,500,865,7204,7355,7685
E02006567,Westbourne & Funtington,360,175,499,374,421,440,449,508,578,695,633,528,556,436,595,6712,6887,7247
E02006568,College Lane & Oaklands,473,249,1556,1040,1066,884,753,721,762,780,676,625,569,453,738,10623,10872,11345
E02006569,"Southbourne, Bosham & Thorney",395,179,720,659,635,656,501,522,582,623,690,609,648,538,752,8135,8314,8709
E02006570,Central Chichester,250,194,1065,756,784,581,548,487,586,607,586,479,576,474,789,8318,8512,8762
E02006571,Stockbridge & Fishbourne,387,174,1006,493,517,498,565,547,616,680,585,532,590,453,692,7774,7948,8335
E02006572,"Tangmere, Mundham & Hunston",523,225,991,890,1039,917,772,766,779,861,729,617,620,468,530,9979,10204,10727
E02006573,Wittering & Birdham,495,203,676,476,558,564,616,673,834,948,947,905,954,895,1153,10199,10402,10897
E02006574,Selsey,424,223,667,535,571,514,507,609,754,936,991,966,1065,903,1163,10181,10404,10828
E02006575,Langley Green & Gatwick Airport,527,249,903,759,946,973,841,672,632,526,498,343,278,185,268,7824,8073,8600
E02006576,Pound Hill,494,238,623,769,992,914,829,755,648,605,591,449,436,286,356,8253,8491,8985
E02006577,Ewhurst & West Green,455,189,656,654,859,823,683,599,615,537,466,392,317,239,437,7277,7466,7921
E02006578,Manor Royal & Northgate,550,225,936,1191,1600,1485,1136,840,774,677,536,397,363,248,394,10577,10802,11352
E02006579,Three Bridges,398,198,650,601,778,819,802,610,593,552,470,361,308,232,355,7131,7329,7727
E02006580,Ifield & Gossops Green,385,183,623,556,710,658,632,532,556,609,504,405,347,244,465,6841,7024,7409
E02006581,Southgate,463,233,787,856,1057,1028,934,700,658,602,488,408,359,220,429,8526,8759,9222
E02006582,Maidenbower East & Worth,466,216,629,435,478,517,668,671,733,602,478,341,334,196,193,6275,6491,6957
E02006583,Maidenbower West & Furnace Green,441,224,673,588,741,760,780,636,695,651,558,464,421,326,433,7726,7950,8391
E02006584,Bewbush,474,200,674,567,701,723,716,542,526,572,473,335,235,138,139,6341,6541,7015
E02006585,Tilgate,492,254,631,552,682,717,672,582,579,540,455,327,287,213,412,6649,6903,7395
E02006586,Broadfield West,525,209,810,733,784,792,699,637,617,514,391,341,251,110,91,6770,6979,7504
E02006587,Broadfield East,474,219,748,656,800,821,724,621,615,556,532,391,294,184,145,7087,7306,7780
E02006588,"Rusper, Faygate & Leechpool",464,196,782,791,941,794,758,731,709,733,597,428,497,367,443,8571,8767,9231
E02006589,Littlehaven,558,297,836,629,658,772,863,814,914,965,888,665,674,523,585,9786,10083,10641
E02006590,Broadbridge Heath & Warnham,436,206,593,501,578,603,598,646,737,741,602,467,490,363,538,7457,7663,8099
E02006591,Horsham East & Roffey,386,195,546,514,600,677,583,608,671,563,506,408,367,322,545,6910,7105,7491
E02006592,"Rudgwick, Slinfold & Barns Green",407,273,581,357,377,368,397,438,576,650,529,423,436,336,413,5881,6154,6561
E02006593,Horsham Central,515,245,839,852,997,914,905,786,876,769,633,515,456,429,909,9880,10125,10640
E02006594,Horsham West,614,236,632,579,849,877,885,784,753,680,597,518,510,352,463,8479,8715,9329
E02006595,"Horsham South, Mannings Heath & Nuthurst",872,449,632,415,462,485,519,571,703,753,599,509,577,424,568,7217,7666,8538
E02006596,Southwater,529,262,738,575,636,610,622,674,794,799,672,502,450,296,368,7736,7998,8527
E02006597,Billingshurst,625,317,830,673,785,818,873,901,989,906,750,629,645,484,636,9919,10236,10861
E02006598,Cowfold & Partridge Green,244,124,399,291,293,277,321,395,460,528,499,403,397,276,349,4888,5012,5256
E02006599,West Chiltington Common,284,122,359,227,198,259,295,374,502,679,661,661,753,621,697,6286,6408,6692
E02006600,"Amberley, Pulborough & Storrington",402,185,549,482,519,550,582,585,679,777,719,696,785,658,942,8523,8708,9110
E02006601,Henfield & Small Dole,370,200,512,458,469,496,479,545,671,758,665,572,622,534,770,7551,7751,8121
E02006602,Ashington & Washington,484,206,582,428,471,456,515,563,694,806,677,565,588,481,465,7291,7497,7981
E02006603,Steyning & Upper Beeding,453,262,585,345,359,432,474,591,675,717,645,618,704,612,820,7577,7839,8292
E02006604,East Grinstead Central & North,613,266,862,843,969,962,979,986,972,878,786,687,635,551,766,10876,11142,11755
E02006605,Copthorne & Turners Hill,385,334,653,407,399,442,431,427,496,484,457,369,370,271,371,5577,5911,6296
E02006606,East Grinstead East,475,175,525,407,420,522,578,566,665,685,591,487,505,410,385,6746,6921,7396
E02006607,East Grinstead West & South,401,176,476,353,378,437,566,611,638,596,494,480,548,446,571,6594,6770,7171
E02006608,Crawley Down,278,129,364,260,379,417,368,407,465,473,477,470,474,349,383,5286,5415,5693
E02006609,"Horsted Keynes, Ardingly & Sharpthorne",413,300,531,301,351,391,412,496,571,618,520,452,420,329,395,5787,6087,6500
E02006610,Balcombe & Handcross,465,201,529,424,454,515,572,600,663,635,521,402,386,346,431,6478,6679,7144
E02006611,Haywards Heath North East,660,281,601,466,646,743,929,866,830,754,618,643,714,643,836,9289,9570,10230
E02006612,Haywards Heath West,498,239,603,776,1010,1082,1015,957,846,685,545,479,519,470,863,9850,10089,10587
E02006613,Haywards Heath East,399,196,521,496,586,572,605,576,553,551,431,353,368,248,304,6164,6360,6759
E02006614,Haywards Heath South & Cuckfield,706,304,877,687,947,964,974,1015,1029,901,703,571,591,478,553,10290,10594,11300
E02006615,Burgess Hill West,353,181,541,459,494,487,507,535,631,559,409,329,287,218,193,5649,5830,6183
E02006616,Burgess Hill East,464,199,664,629,809,804,732,628,721,630,539,460,511,371,478,7976,8175,8639
E02006617,Burgess Hill Central,424,183,649,626,812,833,663,642,679,633,561,439,447,410,548,7942,8125,8549
E02006618,Burgess Hill South,320,165,475,269,345,367,354,447,533,486,449,392,376,349,550,5392,5557,5877
E02006619,Hurstpierpoint & Bolney,580,256,632,390,489,496,635,712,758,696,580,508,461,327,421,7105,7361,7941
E02006620,"Hassocks, Keymer & East Hurstpierpoint",511,243,598,345,491,601,713,809,750,766,599,559,637,537,881,8286,8529,9040
E02006621,High Salvington & Findon Valley,265,142,437,315,327,343,357,464,607,655,590,642,756,623,759,6875,7017,7282
E02006622,Salvington,355,178,546,393,479,488,519,531,599,614,499,504,560,397,573,6702,6880,7235
E02006623,Durrington North,419,204,584,521,602,537,534,477,575,592,480,439,494,397,469,6701,6905,7324
E02006624,Broadwater West,454,219,590,370,332,424,527,611,676,613,516,372,426,330,442,6229,6448,6902
E02006625,Broadwater East,443,214,636,493,527,613,603,664,641,609,475,326,325,217,313,6442,6656,7099
E02006626,Northbrook,620,279,743,681,967,863,757,657,688,611,508,420,368,254,275,7792,8071,8691
E02006627,Durrington South,443,202,695,606,736,676,734,608,729,700,577,487,542,437,602,8129,8331,8774
E02006628,Broadwater South,495,197,706,578,723,823,725,737,749,652,485,357,305,225,324,7389,7586,8081
E02006629,East Worthing,410,217,578,454,532,555,562,596,631,606,493,373,404,269,427,6480,6697,7107
E02006630,Heene,223,102,451,589,638,621,568,569,616,648,510,463,552,482,1002,7709,7811,8034
E02006631,Worthing Central,296,150,732,891,1055,892,771,819,797,726,567,426,440,390,659,9165,9315,9611
E02006632,West Worthing,318,164,475,383,457,486,515,539,597,648,639,543,580,495,757,7114,7278,7596
E02006633,Goring-by-Sea,323,161,491,379,323,347,472,516,574,638,643,619,769,656,898,7325,7486,7809
E02002985,Keynsham North,307,126,462,466,584,534,454,398,409,389,362,328,365,275,535,5561,5687,5994
E02002986,Keynsham South,295,124,489,550,683,572,392,409,418,426,363,306,332,304,426,5670,5794,6089
E02002987,Keynsham East,258,113,416,310,375,309,360,392,418,398,360,336,435,351,458,4918,5031,5289
E02002988,Lambridge & Fairfield Park,274,125,385,307,349,385,403,428,458,455,364,300,320,231,404,4789,4914,5188
E02002989,Weston,333,117,389,344,425,375,409,457,388,425,350,274,258,252,465,4811,4928,5261
E02002990,Walcot,227,121,716,640,563,453,487,447,498,488,343,284,259,174,200,5552,5673,5900
E02002991,Central Bath & Lansdown,557,309,1875,1450,1045,829,728,700,815,813,620,558,585,416,653,11087,11396,11953
E02002992,Newbridge,298,134,619,392,403,378,384,441,434,410,372,293,302,225,344,4997,5131,5429
E02002993,Kingsmead,149,86,1786,1032,608,405,377,341,351,366,293,260,208,151,224,6402,6488,6637
E02002994,Bathavon North & South,673,388,857,466,451,579,692,766,905,922,752,674,716,505,792,9077,9465,10138
E02002995,Twerton,231,115,913,540,508,444,404,334,415,364,266,190,178,164,192,4912,5027,5258
E02002996,"Widcombe, Bathwick Hill & Claverton Down",448,272,5408,1689,689,523,469,517,575,653,565,479,483,337,530,12917,13189,13637
E02002997,Oldfield Park West,178,73,2543,803,565,529,380,329,343,320,276,237,214,188,230,6957,7030,7208
E02002998,Oldfield Park East,194,100,1439,419,381,333,312,311,308,333,281,193,196,142,273,4921,5021,5215
E02002999,Southdown,275,143,682,442,447,421,410,352,372,346,342,272,313,209,297,4905,5048,5323
E02003000,"Saltford, Farmborough & Timsbury",426,207,607,435,503,503,565,596,706,746,767,739,759,627,745,8298,8505,8931
E02003001,Bloomfield,366,164,572,301,313,292,356,456,455,433,386,328,290,225,369,4776,4940,5306
E02003002,Combe Down,367,161,661,471,421,434,439,398,446,454,349,330,308,246,326,5283,5444,5811
E02003003,Odd Down,258,147,777,464,510,449,416,383,407,383,366,270,261,202,313,5201,5348,5606
E02003004,"Pensford, Clutton & Temple Cloud",351,162,489,432,497,465,449,472,562,584,492,436,435,324,427,6064,6226,6577
E02003005,"Chew, Bishop Sutton & East Harptree",357,138,425,296,332,417,468,450,501,585,507,418,469,398,414,5680,5818,6175
E02003006,Peasedown & Bathavon West,450,214,1500,579,618,513,548,637,750,716,613,512,450,382,405,8223,8437,8887
E02003007,High Littleton & Paulton,447,209,637,549,682,639,542,593,669,646,611,529,569,408,552,7626,7835,8282
E02003008,Radstock,306,151,456,432,505,461,384,362,443,411,342,289,262,191,247,4785,4936,5242
E02003009,Midsomer Norton North,291,134,428,397,397,369,406,389,491,477,409,294,352,269,398,5076,5210,5501
E02003010,Westfield,335,150,533,435,524,399,437,428,449,441,364,357,328,223,301,5219,5369,5704
E02003011,Midsomer Norton Redfield,289,146,444,332,359,339,335,369,441,401,339,332,370,343,432,4836,4982,5271
E02003012,Henbury & Brentry,613,307,947,983,1169,1167,980,833,823,800,630,535,552,371,460,10250,10557,11170
E02003013,Southmead,826,381,1364,1110,1188,1137,1055,1017,876,813,623,502,502,373,515,11075,11456,12282
E02003014,Lawrence Weston,539,248,774,670,892,868,646,572,511,496,396,315,305,170,247,6862,7110,7649
E02003015,Monks Park,295,137,688,755,795,713,537,432,416,416,335,289,247,201,259,6083,6220,6515
E02003016,Upper Horfield,418,199,1290,985,896,782,613,490,428,393,322,250,220,154,192,7015,7214,7632
E02003017,Westbury Village,335,126,347,339,415,487,531,505,445,396,372,333,385,330,533,5418,5544,5879
E02003018,Sea Mills,370,161,463,360,535,566,493,449,418,419,399,341,355,233,251,5282,5443,5813
E02003019,Shirehampton & Avonmouth,483,219,859,911,1025,971,843,683,754,739,642,500,493,315,459,9194,9413,9896
E02003020,Westbury on Trym,507,235,376,221,248,415,544,539,495,400,365,346,403,339,667,5358,5593,6100
E02003021,Horfield,269,128,1181,983,875,763,611,451,408,310,289,204,202,140,227,6644,6772,7041
E02003022,Henleaze,333,150,345,277,305,435,516,476,420,440,452,358,355,287,430,5096,5246,5579
E02003023,Stapleton,296,124,901,591,581,505,437,443,413,452,432,328,339,232,343,5997,6121,6417
E02003024,Fishponds North,399,191,1569,1005,1062,957,812,629,611,586,460,392,400,267,497,9247,9438,9837
E02003025,Lockleaze,439,199,836,672,802,796,638,565,487,480,401,285,246,207,319,6734,6933,7372
E02003026,Stoke Bishop,443,221,2932,534,375,486,637,609,616,624,508,542,531,421,674,9489,9710,10153
E02003027,Bishopston,544,240,1787,1527,1470,1341,1236,965,795,736,579,492,387,191,261,11767,12007,12551
E02003028,Westbury Park,512,230,858,881,660,624,671,700,648,627,443,347,397,245,376,7477,7707,8219
E02003029,Fishponds South,461,217,718,526,568,622,587,480,476,435,349,266,223,160,228,5638,5855,6316
E02003030,Eastville,334,160,919,817,925,831,796,639,577,526,396,309,245,188,175,7343,7503,7837
E02003031,Redland & St Andrew's,484,241,1679,1322,1192,872,785,710,714,629,469,421,290,165,144,9392,9633,10117
E02003032,Speedwell,433,174,756,758,981,887,742,582,524,498,423,353,273,193,257,7227,7401,7834
E02003033,Cotham,229,97,2238,1289,981,657,513,398,424,382,311,251,242,174,167,8027,8124,8353
E02003034,St Paul's,554,282,2006,2367,2369,1885,1312,954,838,795,539,354,251,151,193,14014,14296,14850
E02003036,Kingsdown & Stokes Croft,205,115,3038,2002,1265,889,543,434,414,348,273,215,178,105,133,9837,9952,10157
E02003037,Clifton East,201,107,2314,1703,1296,827,571,455,430,402,310,257,229,160,182,9136,9243,9444
E02003038,Two Mile Hill,312,148,573,599,739,663,543,505,494,471,394,252,264,206,262,5965,6113,6425
E02003039,St George,412,198,729,800,1063,931,773,659,586,564,391,331,304,250,324,7705,7903,8315
E02003040,Redfield,280,116,666,1195,1769,1528,960,737,628,535,367,259,246,203,332,9425,9541,9821
E02003041,Clifton Village,326,230,1305,1001,822,511,398,324,346,316,286,258,296,209,239,6311,6541,6867
E02003043,Bristol City Centre,197,116,9231,3828,2180,1285,797,546,459,428,336,258,253,170,134,19905,20021,20218
E02003044,Crews Hole,244,120,412,482,673,609,439,389,483,408,337,252,279,246,279,5288,5408,5652
E02003045,Hotwells,180,90,1877,1045,692,522,390,367,316,338,278,240,264,156,133,6618,6708,6888
E02003046,St Annes,403,171,772,1015,1351,1218,897,719,658,583,454,362,314,203,274,8820,8991,9394
E02003047,Southville,433,160,901,1611,1512,1139,1035,811,712,658,464,404,309,205,288,10049,10209,10642
E02003048,Totterdown,216,104,443,854,975,871,679,571,439,386,293,197,151,113,108,6080,6184,6400
E02003049,Broom Hill,334,122,565,662,799,804,661,504,502,527,406,366,350,281,327,6754,6876,7210
E02003050,Bedminster,214,101,910,1771,1833,1320,843,595,556,467,448,293,269,202,333,9840,9941,10155
E02003051,Windmill Hill,375,164,604,883,966,939,683,559,433,405,270,227,173,119,132,6393,6557,6932
E02003052,Ashton,288,114,482,704,863,755,635,468,436,366,333,293,291,221,261,6108,6222,6510
E02003053,Knowle Park,390,200,626,572,744,785,737,667,648,547,451,396,345,223,334,7075,7275,7665
E02003054,Brislington,291,144,472,531,697,656,504,513,460,472,380,307,292,204,292,5780,5924,6215
E02003055,Knowle,651,321,912,651,829,897,755,614,590,563,429,323,281,195,236,7275,7596,8247
E02003056,Knowle West,541,232,719,570,692,615,613,547,514,524,426,337,304,182,223,6266,6498,7039
E02003057,Bishopsworth,283,133,445,462,601,560,521,388,369,388,376,297,328,209,343,5287,5420,5703
E02003058,Hengrove,494,207,740,718,844,768,618,518,611,596,554,480,455,382,461,7745,7952,8446
E02003059,Headley Park,341,147,546,579,670,558,430,398,399,425,353,319,244,209,348,5478,5625,5966
E02003060,Stockwood,501,241,897,768,868,792,757,680,771,797,743,597,586,540,783,9579,9820,10321
E02003061,Highridge,402,159,547,490,594,549,422,312,422,396,364,265,218,166,252,4997,5156,5558
E02003062,Withywood,390,161,566,493,555,472,395,365,425,433,333,246,193,157,263,4896,5057,5447
E02003063,Whitchurch Park,303,131,491,413,521,497,447,382,452,488,566,485,470,377,486,6075,6206,6509
E02003064,Hartcliffe,456,217,795,657,724,611,525,401,488,495,364,259,176,118,264,5877,6094,6550
E02006887,Temple Meads,296,133,2496,2154,1754,1105,726,540,405,303,235,159,125,79,81,10162,10295,10591
E02006888,Upper Easton,425,203,761,940,1086,981,769,665,541,471,296,213,140,68,156,7087,7290,7715
E02006889,Barton Hill,605,244,802,971,1032,956,849,651,536,427,297,205,157,128,168,7179,7423,8028
E02006890,Lower Easton,409,181,936,1108,1393,1335,1029,770,653,611,394,259,170,125,203,8986,9167,9576
E02003065,Portishead Central,464,190,575,533,656,715,735,689,743,777,598,558,642,499,727,8447,8637,9101
E02003066,Portishead Redcliffe,264,142,353,215,294,330,384,390,467,509,552,431,503,433,478,5339,5481,5745
E02003067,Portishead South,526,222,530,422,443,599,682,756,577,529,434,382,455,379,484,6672,6894,7420
E02003068,Pill & Easton,300,165,477,354,418,421,455,426,542,494,433,370,441,367,471,5669,5834,6134
E02003069,Clevedon North & Walton,226,125,318,205,229,272,330,368,442,484,424,371,465,350,578,4836,4961,5187
E02003070,Long Ashton & Gordano,718,316,740,500,632,874,1126,1087,1019,944,800,693,830,637,870,10752,11068,11786
E02003071,Clevedon Central,362,162,522,428,475,510,514,511,608,638,517,529,498,440,791,6981,7143,7505
E02003072,Nailsea West,381,185,609,458,512,556,521,544,639,721,602,629,720,638,947,8096,8281,8662
E02003073,Nailsea East,310,146,431,272,342,350,380,427,434,490,480,468,538,443,407,5462,5608,5918
E02003074,Clevedon South & Yeo,342,141,477,465,583,572,503,452,517,602,538,506,445,345,425,6430,6571,6913
E02003075,Backwell & Flax Bourton,368,167,409,265,274,330,464,491,485,496,406,347,361,330,401,5059,5226,5594
E02003076,Yatton & Cleeve,502,221,632,543,604,594,657,672,760,747,689,606,657,485,612,8258,8479,8981
E02003077,"Wrington, Felton & Dundry",301,143,428,324,336,392,389,461,543,567,418,431,375,386,418,5468,5611,5912
E02003078,Congresbury & Kewstoke,367,175,565,347,391,430,434,486,560,624,527,496,601,447,439,6347,6522,6889
E02003079,North Worle,494,223,688,532,647,662,638,616,687,716,627,563,541,378,383,7678,7901,8395
E02003080,Mid Worle,380,199,618,458,456,522,493,528,594,591,606,537,702,605,758,7468,7667,8047
E02003081,Weston Milton,420,213,673,451,509,580,532,604,769,740,662,606,741,596,724,8187,8400,8820
E02003082,Weston Hillside,258,102,586,642,670,570,537,581,762,824,674,529,650,507,838,8370,8472,8730
E02003084,Weston Town,382,226,888,953,1032,964,833,741,891,829,643,506,516,372,659,9827,10053,10435
E02003085,Weston Bournville,487,226,786,672,673,643,504,533,652,579,441,366,303,207,241,6600,6826,7313
E02003086,Weston Clarence,235,129,453,366,387,384,364,430,516,526,418,399,432,323,641,5639,5768,6003
E02003087,"Hutton, Locking & Banwell",504,236,651,529,677,654,625,652,735,819,790,770,851,692,695,9140,9376,9880
E02003088,"Winscombe, Langford & Blagdon",492,284,637,422,447,457,509,581,661,692,664,648,646,601,784,7749,8033,8525
E02003089,Weston Uphill,324,148,458,325,354,386,350,380,438,473,432,377,412,369,435,5189,5337,5661
E02006845,"South Worle, West Wick & St Georges",594,228,663,617,770,764,754,704,650,609,452,449,372,328,377,7509,7737,8331
E02006846,Weston Winterstoke,560,257,774,855,1063,954,761,659,616,489,346,266,195,124,114,7216,7473,8033
E02003090,Thornbury North,475,202,625,627,767,742,700,639,642,607,490,460,537,499,589,7924,8126,8601
E02003091,Thornbury South,318,171,504,400,416,403,401,427,534,523,422,388,453,368,492,5731,5902,6220
E02003092,"Charfield, Wickwar & Iron Acton",423,223,633,507,549,519,606,605,798,920,633,483,467,345,365,7430,7653,8076
E02003093,"Alveston, Olveston & Oldbury",273,136,435,288,324,332,387,388,512,548,514,432,496,491,625,5772,5908,6181
E02003094,"Almondsbury, Pilning & Severn Beach",465,226,711,567,657,578,645,612,685,734,619,521,481,390,486,7686,7912,8377
E02003095,Yate North,401,198,712,658,642,550,530,577,630,653,559,420,481,322,390,7124,7322,7723
E02003096,Yate West,274,154,559,529,493,470,361,365,511,498,377,307,332,253,336,5391,5545,5819
E02003097,Chipping Sodbury,264,161,424,314,384,377,384,373,486,524,397,420,487,465,598,5633,5794,6058
E02003098,Bradley Stoke North East,576,282,858,883,916,1035,916,831,882,723,478,345,257,177,155,8456,8738,9314
E02003099,Yate Kingsgate,350,180,569,510,614,514,468,483,551,535,429,419,422,393,525,6432,6612,6962
E02003100,Patchway,725,288,1192,1455,1639,1629,1242,993,936,896,703,592,554,472,639,12942,13230,13955
E02003101,Bradley Stoke Central,645,256,937,995,1015,1075,980,859,905,781,542,355,269,230,231,9174,9430,10075
E02003102,Frampton Cotterell,392,192,545,374,391,438,507,493,537,603,429,349,394,381,446,5887,6079,6471
E02003103,Yate South,347,167,576,584,638,580,472,474,470,489,401,297,345,223,181,5730,5897,6244
E02003104,Stoke Gifford,337,147,632,584,614,553,532,501,580,584,461,444,404,302,305,6496,6643,6980
E02003105,Winterbourne,320,151,490,368,368,359,390,373,522,496,439,342,373,370,594,5484,5635,5955
E02003106,Frenchay & Great Stoke,608,334,6133,2299,1502,1409,1301,1118,1038,768,568,375,392,335,525,17763,18097,18705
E02003107,Filton,426,201,1959,1396,1137,949,754,728,638,637,504,431,445,396,532,10506,10707,11133
E02003108,Pucklechurch & Westerleigh,528,249,912,1044,1028,951,770,729,807,881,712,602,610,477,652,10175,10424,10952
E02003109,Downend North,306,156,443,290,315,409,458,428,546,423,364,300,369,328,481,5154,5310,5616
E02003110,Emersons Green,744,359,925,724,907,955,926,1046,999,774,565,454,404,339,341,9359,9718,10462
E02003111,Downend South,331,135,477,387,431,464,519,515,450,462,410,350,405,286,546,5702,5837,6168
E02003112,Mangotsfield,330,157,508,438,528,542,405,402,438,415,398,296,328,266,388,5352,5509,5839
E02003113,"Marshfield, Wick & Hawkesbury",504,258,723,553,597,636,634,650,838,988,906,734,682,557,652,9150,9408,9912
E02003114,Staple Hill North,278,119,520,536,544,549,448,419,496,491,439,347,398,305,506,5998,6117,6395
E02003115,Staple Hill South & Kingswood North West,457,204,738,802,957,842,749,696,656,618,497,448,422,363,501,8289,8493,8950
E02003116,Kingswood North East,340,168,619,621,714,588,450,464,524,513,414,346,368,331,553,6505,6673,7013
E02003117,Kingswood South,444,197,641,743,894,831,675,584,660,577,467,382,401,321,475,7651,7848,8292
E02003118,Cadbury Heath North & Bridgeyate,448,209,788,775,779,658,649,638,770,866,672,514,458,350,385,8302,8511,8959
E02003119,Cadbury Heath South & North Common,552,267,783,725,765,713,645,635,782,784,665,568,557,360,488,8470,8737,9289
E02003120,Hanham,382,183,706,615,583,640,605,566,675,740,587,499,572,441,639,7868,8051,8433
E02003121,Longwell Green & Oldland Common,391,188,704,577,642,610,623,588,733,734,748,696,706,581,756,8698,8886,9277
E02003122,Glenholt & Widewell,323,141,404,328,432,414,395,372,480,546,548,529,546,487,644,6125,6266,6589
E02003123,Southway,455,205,640,611,685,632,492,476,603,607,564,401,410,352,461,6934,7139,7594
E02003124,Tamerton Foliot,463,184,628,590,676,588,532,508,590,584,451,375,323,287,345,6477,6661,7124
E02003125,Ernesettle,276,130,453,386,412,332,328,361,411,495,458,368,347,257,298,4906,5036,5312
E02003126,Derriford & Estover,367,181,923,538,573,582,544,478,442,431,558,660,622,376,330,7057,7238,7605
E02003127,King's Tamerton & West Park,447,206,627,466,558,503,479,461,489,558,439,379,364,274,342,5939,6145,6592
E02003128,Honicknowle & Manadon,461,182,647,637,674,690,571,552,645,636,562,433,472,368,392,7279,7461,7922
E02003129,Crownhill,287,152,406,301,370,357,347,356,365,459,413,351,385,297,401,4808,4960,5247
E02003130,St Budeaux,559,258,831,648,748,708,642,640,731,770,732,552,521,377,417,8317,8575,9134
E02003131,Deer Park & Leigham,372,170,543,429,499,488,462,475,479,480,465,405,451,385,377,5938,6108,6480
E02003132,"Ham, Beacon Park & Pennycross",479,200,625,544,642,610,612,566,641,637,562,477,434,343,419,7112,7312,7791
E02003133,Higher Compton & Eggbuckland,338,172,531,421,469,428,407,445,527,581,514,403,431,372,405,5934,6106,6444
E02003134,North Prospect,393,195,552,522,610,581,485,405,478,492,449,337,284,180,266,5641,5836,6229
E02003135,Keyham,366,172,1743,1443,1340,1174,863,672,677,534,379,296,236,167,183,9707,9879,10245
E02003136,Plympton St Mary,371,157,514,354,363,398,468,475,578,606,504,493,607,528,821,6709,6866,7237
E02003137,Mannamead & Hartley,438,200,530,387,387,416,501,564,658,648,501,452,470,398,716,6628,6828,7266
E02003138,Peverell,357,172,582,536,567,658,577,598,638,595,436,319,270,223,256,6255,6427,6784
E02003139,Plympton Chaddlewood,325,174,450,457,513,455,416,451,543,474,409,314,309,215,171,5177,5351,5676
E02003140,Plympton Underwood,434,202,478,385,487,498,473,557,604,581,471,399,471,337,521,6262,6464,6898
E02003141,Ford & Blockhouse Park,336,165,655,687,677,643,550,532,641,656,502,339,325,227,261,6695,6860,7196
E02003142,"Efford, Laira & Crabtree",496,214,706,638,718,702,560,573,673,654,567,489,422,333,387,7422,7636,8132
E02003143,Plympton St Maurice,335,148,477,408,507,463,411,392,531,508,550,438,478,344,416,5923,6071,6406
E02003144,Mutley,187,114,3185,1506,927,605,474,370,390,338,260,204,200,154,292,8905,9019,9206
E02003145,Stoke & Pennycomequick,281,155,664,525,516,487,460,445,485,536,430,333,345,259,371,5856,6011,6292
E02003146,Lipson,318,154,1417,1181,960,728,592,594,542,408,356,279,235,149,203,7644,7798,8116
E02003147,"Devonport, Mount Wise & Morice Town",522,220,797,800,860,827,666,586,642,566,502,389,329,206,244,7414,7634,8156
E02003148,"City Centre, Barbican & Sutton Harbour",231,130,4941,1908,953,697,572,485,454,471,423,355,301,213,287,12060,12190,12421
E02003149,Cattedown & Prince Rock,360,171,1525,1147,1028,834,742,624,542,523,436,354,275,204,213,8447,8618,8978
E02003150,Millbay & Stonehouse,458,231,1659,1670,1511,1293,1038,867,913,849,817,646,561,358,524,12706,12937,13395
E02003151,Plymstock Elburton,469,162,460,337,385,455,477,448,555,630,559,526,641,551,863,6887,7049,7518
E02003152,Plymstock Hooe & Oreston,521,260,788,552,676,725,697,761,858,839,723,653,695,539,691,9197,9457,9978
E02003153,Plymstock Goosewell & Staddiscombe,325,155,458,375,411,417,348,426,488,506,492,408,479,417,554,5779,5934,6259
E02003154,Watcombe,370,178,526,436,486,448,401,386,504,544,479,398,436,363,481,5888,6066,6436
E02003155,St Marychurch & Maidencombe,256,112,370,324,336,297,287,348,467,484,422,409,433,386,572,5135,5247,5503
E02003156,Shiphay & the Willows,562,257,733,693,731,686,708,737,768,765,655,591,568,447,450,8532,8789,9351
E02003157,Upton & Hele,334,162,496,494,540,503,397,423,503,581,445,374,350,228,268,5602,5764,6098
E02003158,Babbacombe & Plainmoor,258,126,382,304,326,327,306,361,443,415,368,359,434,340,554,4919,5045,5303
E02003159,Ellacombe,299,132,521,418,482,419,422,409,432,485,382,298,280,195,218,4961,5093,5392
E02003161,Torquay Central,286,207,707,685,660,657,564,567,670,605,553,471,386,249,351,7125,7332,7618
E02003163,Wellswood,179,98,346,343,365,330,384,463,648,746,754,702,885,695,1031,7692,7790,7969
E02003164,Preston & Shorton,382,197,573,414,470,469,504,548,702,711,620,683,700,607,785,7786,7983,8365
E02003165,Clifton & Maidenway,355,172,492,372,424,437,453,464,574,601,473,453,480,356,470,6049,6221,6576
E02003166,Blatchcombe & Blagdon,762,349,978,828,909,837,784,766,916,958,780,683,638,509,528,10114,10463,11225
E02003167,Paignton Central,324,160,696,572,648,553,517,604,770,820,828,687,649,568,1005,8917,9077,9401
E02003168,Goodrington & Roselands,281,175,441,349,383,347,338,395,540,650,582,545,605,534,560,6269,6444,6725
E02003169,Churston & Galmpton,211,115,338,211,247,251,301,335,427,512,580,588,762,597,783,5932,6047,6258
E02003170,Brixham Town,340,174,535,390,441,369,390,518,692,843,843,830,903,772,868,8394,8568,8908
E02003171,Higher Brixham,309,155,455,320,375,356,318,396,576,613,624,582,600,470,629,6314,6469,6778
E02006840,"Chelston, Cockington & Livermead",612,293,802,646,705,699,662,728,825,851,784,710,697,574,698,9381,9674,10286
E02003212,Highworth,397,173,599,471,417,465,495,584,638,657,596,612,620,473,605,7232,7405,7802
E02003214,Penhill,388,158,519,491,555,456,392,380,385,435,330,271,254,155,245,4868,5026,5414
E02003215,Haydon Wick,239,117,438,333,388,376,363,457,524,582,497,404,515,427,503,5807,5924,6163
E02003216,Upper Stratton,413,212,708,574,653,638,578,626,776,744,648,554,564,455,588,8106,8318,8731
E02003217,Moredon,429,173,530,473,563,544,513,480,503,501,403,360,348,252,322,5792,5965,6394
E02003218,Pinehurst,406,192,570,416,463,470,405,447,443,521,365,338,299,213,256,5206,5398,5804
E02003219,"Broad Blunsdon, South Marston & Wanborough",696,252,786,796,980,1094,959,880,893,821,718,539,492,346,412,9716,9968,10664
E02003220,Lower Stratton,429,222,738,632,733,639,591,631,829,911,718,593,486,437,795,8733,8955,9384
E02003221,Gorse Hill,342,164,607,590,695,591,591,583,566,476,402,305,246,180,225,6057,6221,6563
E02003222,Roughmoor,293,141,408,438,432,482,417,417,478,550,456,313,228,117,123,4859,5000,5293
E02003223,Rodbourne & Cheney Manor,491,225,749,825,1059,1049,915,808,758,643,592,423,350,244,324,8739,8964,9455
E02003224,Covingham,338,158,550,469,555,539,462,526,604,703,634,568,545,438,634,7227,7385,7723
E02003225,Westlea & Shaw,275,130,397,439,563,513,445,403,455,500,479,351,308,167,178,5198,5328,5603
E02003226,Central North,589,272,1075,1163,1438,1341,1109,998,920,742,545,322,253,152,176,10234,10506,11095
E02003227,Walcot East,458,228,679,513,603,562,503,542,490,499,400,272,219,156,215,5653,5881,6339
E02003228,Central East & Walcot West,406,197,602,576,660,669,641,618,563,578,441,345,287,220,351,6551,6748,7154
E02003229,Freshbrook North & Grange Park,292,135,390,376,434,445,367,414,461,510,445,324,236,119,98,4619,4754,5046
E02003230,Central South & Eastcott,374,122,681,989,1326,1300,956,667,617,455,401,282,207,148,230,8259,8381,8755
E02003231,Park North & Park South,563,269,774,677,783,718,636,582,593,660,486,382,317,243,353,7204,7473,8036
E02003232,Kingshill & Okus,444,219,649,587,726,764,757,696,701,635,458,365,330,201,331,7200,7419,7863
E02003233,Freshbrook South & Toothill,492,225,595,581,712,680,656,507,567,630,654,551,472,299,329,7233,7458,7950
E02003234,Eldene & Dorcan,347,200,634,543,553,580,517,541,611,683,637,513,570,367,452,7201,7401,7748
E02003235,Lawn & East Wichel,401,200,584,602,731,806,741,626,611,621,610,465,461,372,618,7848,8048,8449
E02003236,"Wroughton, Wichelstowe & Chiseldon",602,281,826,744,793,824,813,893,936,955,793,707,726,638,907,10555,10836,11438
E02006847,Mouldon Hill & Oakhurst,728,302,794,555,658,875,1009,944,822,562,340,277,221,189,144,7390,7692,8420
E02006848,Abbey Park,618,226,613,559,739,863,873,760,583,401,267,181,117,75,89,6120,6346,6964
E02006849,Groundwell & Abbey Meads,569,269,779,515,698,739,825,930,929,715,494,346,340,217,240,7767,8036,8605
E02003892,Gunnislake & Calstock,240,132,375,283,298,311,304,349,495,692,661,599,600,447,441,5855,5987,6227
E02003893,St Neot & St Cleer,277,130,396,291,287,306,269,397,515,681,658,613,529,426,376,5744,5874,6151
E02003894,Callington & Pensilva,360,172,555,438,468,477,390,516,673,683,647,545,591,483,592,7058,7230,7590
E02003895,"Dobwalls, Addington & Menheniot",451,191,596,583,613,575,529,562,649,763,664,596,647,445,504,7726,7917,8368
E02003896,Liskeard,271,144,471,327,390,300,354,397,430,435,366,388,425,329,426,5038,5182,5453
E02003897,Saltash Latchbrook & St Stephens,245,127,331,229,242,240,247,370,446,474,453,368,435,317,284,4436,4563,4808
E02003898,St Germans & St Mellion,275,141,409,256,270,325,339,393,570,666,552,572,582,455,435,5824,5965,6240
E02003899,Mid Saltash,221,118,356,265,281,325,318,310,369,406,361,362,456,343,395,4547,4665,4886
E02003900,Saltash Town & Pillmere,378,185,444,369,425,405,434,454,523,554,510,452,450,403,452,5875,6060,6438
E02003901,"Lanreath, Pelynt & Polraun",351,159,476,344,372,396,372,446,598,745,750,701,786,528,647,7161,7320,7671
E02003902,Torpoint,245,122,386,289,295,298,309,318,366,441,419,359,348,284,349,4461,4583,4828
E02003903,"Kingsand, Antony & Maryfield",260,257,896,425,365,374,382,402,468,586,540,505,527,398,397,6265,6522,6782
E02003904,Looe & Polperro,166,95,273,158,169,169,182,287,459,491,474,467,510,332,447,4418,4513,4679
E02003905,"Grampound Road, St Newlyn East and Cubert",348,180,433,353,492,458,508,483,587,582,514,454,486,290,323,5963,6143,6491
E02003906,Perranporth & Goonhavern,313,152,349,325,379,418,502,448,525,441,473,436,455,376,469,5596,5748,6061
E02003907,St Agnes & Mount Hawke,449,200,468,428,507,617,624,694,673,674,559,548,587,450,523,7352,7552,8001
E02003908,Truro East,483,267,680,518,524,533,560,583,629,565,534,447,524,397,572,7066,7333,7816
E02003909,Truro West,449,201,847,779,818,755,727,641,690,760,653,611,611,465,689,9046,9247,9696
E02003910,Truro South & Central,333,162,524,546,566,494,508,471,479,510,382,376,394,325,499,6074,6236,6569
E02003911,"Shortlanesend, Chacewater & Carnon Downs",376,206,533,420,482,543,564,616,692,773,679,617,778,637,720,8054,8260,8636
E02003912,Probus & Roseland,361,174,493,410,403,437,438,493,607,717,701,590,693,528,683,7193,7367,7728
E02003913,Mylor Bridge & Frogpool,229,105,318,238,281,277,362,308,411,487,538,491,564,456,490,5221,5326,5555
E02003914,Penryn,305,162,1687,845,672,554,480,470,504,521,366,372,323,296,322,7412,7574,7879
E02003915,Falmouth North,279,154,1583,748,638,467,449,443,469,499,445,398,388,296,358,7181,7335,7614
E02003916,Falmouth East,163,77,1693,626,417,338,304,316,354,378,366,373,450,327,538,6480,6557,6720
E02003917,Falmouth West & South,354,149,704,477,574,530,486,496,564,617,568,544,471,391,472,6894,7043,7397
E02003918,Illogan & Portreath,280,135,440,367,429,410,416,476,535,574,593,528,490,415,454,6127,6262,6542
E02003919,Redruth North,343,135,539,493,605,497,468,439,571,593,486,383,422,291,374,6161,6296,6639
E02003920,Redruth South,379,185,508,460,596,601,519,493,567,618,485,451,476,377,457,6608,6793,7172
E02003921,St Day & Lanner,279,141,336,315,388,347,364,411,477,519,456,427,455,358,409,5262,5403,5682
E02003922,Pool & Illogan Highway,451,197,624,577,717,630,610,597,770,676,581,483,497,364,383,7509,7706,8157
E02003923,Camborne East,435,173,700,681,732,612,569,556,609,589,493,463,500,363,381,7248,7421,7856
E02003924,Camborne West,303,163,489,424,450,416,378,419,506,579,525,462,516,456,629,6249,6412,6715
E02003925,Camborne South,397,158,801,626,715,575,561,563,609,596,491,438,445,316,393,7129,7287,7684
E02003926,"Crowan, Wendron & Stithians",360,199,504,446,532,464,480,559,706,784,667,610,583,409,434,7178,7377,7737
E02003927,"Ponsanooth, Mabe Burnthouse & Constantine",413,196,2387,660,627,560,574,632,638,761,735,766,781,580,679,10380,10576,10989
E02003928,Helston,631,302,792,651,748,706,712,689,834,851,793,645,658,535,709,9323,9625,10256
E02003929,"Porthleven, Breage & Praa Sands",265,135,405,273,347,349,349,405,558,628,580,563,621,449,489,6016,6151,6416
E02003930,The Lizard,428,206,848,591,615,561,574,626,649,767,774,739,811,578,686,8819,9025,9453
E02003931,Bude & Stratton,540,233,658,542,587,572,620,706,717,765,765,803,783,625,839,8982,9215,9755
E02003932,Poundstock & Kilkhampton,368,153,391,299,415,418,418,448,528,617,713,669,601,405,509,6431,6584,6952
E02003933,Crackington & Tintagel,280,134,357,294,325,322,340,436,519,616,691,615,577,458,476,6026,6160,6440
E02003934,Camelford & Tresmeer,342,149,424,294,327,406,355,439,516,614,575,529,594,389,423,5885,6034,6376
E02003935,Launceston,528,247,819,652,753,724,692,657,788,770,638,545,534,422,588,8582,8829,9357
E02003936,Altarnun & Stoke Climsland,332,172,452,347,362,389,393,494,674,833,829,696,770,564,600,7403,7575,7907
E02003937,Trebetherick & Whitecross,244,132,326,218,265,275,312,299,415,428,443,374,428,334,458,4575,4707,4951
E02003938,Padstow & St Issey,274,134,439,391,410,466,428,458,487,505,489,421,462,375,389,5720,5854,6128
E02003939,Wadebridge,333,161,441,381,351,383,439,457,494,514,439,421,539,440,582,5881,6042,6375
E02003940,"St Breward, Tredethy & Lanivet",260,122,322,267,307,313,313,362,524,602,566,494,556,399,452,5477,5599,5859
E02003941,Bodmin East,454,188,654,589,644,615,580,528,637,617,558,456,489,376,516,7259,7447,7901
E02003942,Bodmin West,388,178,673,570,645,517,476,528,551,586,512,402,408,349,401,6618,6796,7184
E02003943,St Ives & Halsetown,265,141,453,401,432,388,417,473,508,575,563,553,556,417,491,6227,6368,6633
E02003944,Hayle,506,209,660,571,680,618,606,667,727,763,687,605,761,585,670,8600,8809,9315
E02003945,"Towednack, Lelant & Carbis Bay",235,114,333,230,298,292,305,341,473,520,517,488,560,446,469,5272,5386,5621
E02003946,"Marazion, St Erth & Gwinear Gwithian",450,207,571,501,562,571,595,655,771,764,737,654,738,572,630,8321,8528,8978
E02003947,West Penwith & St Buryan,282,122,376,302,344,348,332,422,514,592,585,550,586,398,454,5803,5925,6207
E02003948,Penzance North,400,183,658,484,485,450,445,505,616,660,575,499,598,473,615,7063,7246,7646
E02003949,Penzance Quay,231,131,449,408,448,399,398,453,539,627,516,477,488,363,485,6050,6181,6412
E02003950,St Just & Land's End,241,128,296,218,220,283,290,320,415,488,478,494,437,323,329,4591,4719,4960
E02003951,Penzance South & Newlyn,241,92,346,283,286,284,314,360,491,514,463,454,532,447,510,5284,5376,5617
E02003952,St Columb Minor & Porth,486,219,624,554,800,785,744,679,742,655,617,546,552,375,463,8136,8355,8841
E02003953,St Columb Major & St Mawgan,576,210,740,673,796,837,843,819,901,841,749,631,683,501,534,9548,9758,10334
E02003954,Newquay West,250,136,587,673,775,725,691,645,610,539,486,464,425,289,427,7336,7472,7722
E02003955,Newquay East,455,194,810,728,862,760,792,818,807,724,630,574,616,460,574,9155,9349,9804
E02003956,Roche & Goss Moor,400,170,579,504,585,535,517,567,613,608,579,470,463,345,329,6694,6864,7264
E02003957,Lostwithiel & Penwithick,533,233,677,629,683,675,602,619,869,909,829,739,745,588,589,9153,9386,9919
E02003958,"Trewoon, Coombe & Foxhole",437,181,577,482,496,479,445,493,663,674,587,548,499,371,368,6682,6863,7300
E02003959,Par,342,160,494,415,437,448,406,438,532,527,487,445,431,331,408,5799,5959,6301
E02003960,Tywardreath & Fowey,205,114,377,237,262,249,257,374,458,502,491,503,496,438,518,5162,5276,5481
E02003961,St Austell East & Carlyon Bay,445,205,647,466,520,531,549,619,698,721,690,654,716,548,653,8012,8217,8662
E02003962,St Austell North & Carclaze,312,177,516,439,491,462,404,461,575,547,477,424,475,316,361,5948,6125,6437
E02003963,St Austell Central,456,210,731,576,673,604,589,592,701,718,648,561,596,492,740,8221,8431,8887
E02003964,Mevagissey & Polgooth,312,154,437,313,314,322,380,493,598,712,696,665,748,636,701,7015,7169,7481
E02006781,Isles of Scilly,95,27,218,192,163,173,166,130,170,182,133,122,141,134,163,2087,2114,2209
E02006634,"Ramsbury, Ogbournes & Avebury",405,184,606,402,410,424,532,643,719,833,687,634,599,448,557,7494,7678,8083
E02006635,Marlborough,899,606,835,447,406,400,451,572,711,635,569,512,513,483,835,7369,7975,8874
E02006636,Pewsey & Lockeridge,305,136,428,330,338,375,354,496,590,687,585,517,526,425,490,6141,6277,6582
E02006637,Devizes East,561,252,805,648,699,689,693,741,797,855,690,557,594,484,654,8906,9158,9719
E02006638,Devizes West,242,101,399,341,327,310,324,409,463,541,512,449,512,446,627,5660,5761,6003
E02006639,Potterne & Rowde,321,182,559,401,452,392,448,557,716,825,739,588,650,530,517,7374,7556,7877
E02006640,"Bedwyn, Burbage & Collingbourne",380,170,523,326,305,370,502,584,649,665,578,522,538,340,424,6326,6496,6876
E02006641,Market Lavington & Bishops Cannings,539,299,627,369,400,386,443,497,666,741,643,562,527,388,521,6770,7069,7608
E02006642,Netheravon & Upavon,226,118,373,203,215,260,289,380,450,551,518,414,395,273,293,4614,4732,4958
E02006643,Tidworth & Ludgershall,874,419,3038,2578,2646,2249,1788,1166,1028,739,603,461,421,239,262,17218,17637,18511
E02006644,Cricklade & Ashton Keynes,357,159,517,320,363,340,386,493,602,587,561,513,559,381,387,6009,6168,6525
E02006645,"Malmesbury, Crudwell & Oaksey",442,180,562,414,509,494,524,591,594,635,519,429,447,355,428,6501,6681,7123
E02006646,Lydiard Millicent & Purton,416,193,516,438,582,603,613,576,608,645,527,399,399,294,504,6704,6897,7313
E02006647,"Somerford, Dauntsey & Minety",317,129,397,245,238,300,361,468,511,599,557,466,477,362,362,5343,5472,5789
E02006648,Sherston & Hullavington,327,147,354,261,294,296,350,464,480,561,437,364,393,340,422,5016,5163,5490
E02006649,Royal Wootton Bassett Town,349,174,517,484,492,498,477,525,558,645,474,466,435,321,458,6350,6524,6873
E02006650,Royal Wootton Bassett Outer & Lyneham,574,407,1943,1206,1231,1083,978,874,920,920,799,681,736,619,662,12652,13059,13633
E02006651,"Sutton Benger, Kington & Biddestone",353,182,456,316,359,337,449,513,654,661,612,481,486,381,397,6102,6284,6637
E02006652,Chippenham North,536,295,836,698,622,547,617,714,878,828,576,448,412,311,406,7893,8188,8724
E02006653,Chippenham West,477,279,807,708,668,642,622,643,781,772,655,546,530,376,462,8212,8491,8968
E02006654,Chippenham South & East,361,179,706,675,697,653,579,637,712,722,562,476,489,453,737,8098,8277,8638
E02006655,Derry Hill & Hilmarton,368,195,558,438,427,415,395,516,683,764,666,511,539,397,558,6867,7062,7430
E02006656,Chippenham Pewsham,286,177,528,479,523,416,433,484,607,617,538,362,299,169,190,5645,5822,6108
E02006657,Calne North,785,380,877,677,763,709,654,816,863,780,618,489,482,371,402,8501,8881,9666
E02006658,Calne South,327,155,477,497,473,441,411,532,608,690,574,497,512,400,464,6576,6731,7058
E02006659,"Box, Colerne & Rudloe",394,187,477,453,512,543,544,584,629,582,507,475,474,371,439,6590,6777,7171
E02006660,"Corsham, Bowden Hill & Lacock",630,319,840,686,803,973,864,921,1041,1009,871,806,853,664,892,11223,11542,12172
E02006661,"Larkhill, Shrewton & Bulford Camp",421,212,1852,1869,1965,1673,1064,564,486,469,377,273,235,178,207,11212,11424,11845
E02006662,Durrington & Bulford,290,132,470,416,455,464,361,424,434,478,438,402,384,253,288,5267,5399,5689
E02006663,Amesbury,666,318,924,806,857,864,834,870,913,862,841,596,546,427,651,9991,10309,10975
E02006664,"Great Wishford, Woodford Valley & Porton",296,141,393,286,271,311,332,386,538,564,518,468,449,355,421,5292,5433,5729
E02006665,Mere & East Knoyle,241,124,424,314,297,325,297,387,492,616,549,598,615,520,616,6050,6174,6415
E02006666,Salisbury Bishopsdown,407,171,433,326,384,446,473,499,501,518,401,334,341,261,365,5282,5453,5860
E02006667,Salisbury Bemerton,440,184,567,537,620,613,530,447,519,467,350,323,273,185,201,5632,5816,6256
E02006668,Salisbury Stratford,272,138,410,277,325,302,329,404,443,518,442,374,387,353,444,5008,5146,5418
E02006669,"Wilton, Nadder & Ebble",416,177,594,454,552,603,558,617,831,886,811,676,762,604,839,8787,8964,9380
E02006670,Salisbury Churchfields,257,108,421,497,580,560,482,474,469,483,476,380,353,279,395,5849,5957,6214
E02006671,Salisbury Town North & Milford,283,147,426,465,522,465,403,443,458,438,393,372,382,306,510,5583,5730,6013
E02006672,"Laverstock, Bodenham & Coombe Bissett",508,218,601,597,728,694,634,585,581,608,490,411,478,373,651,7431,7649,8157
E02006673,Salisbury Cathedral & Harnham,210,99,312,304,311,284,281,323,344,301,360,386,385,331,553,4475,4574,4784
E02006674,Salisbury East Harnham,326,149,436,333,401,399,422,413,401,435,412,339,325,242,371,4929,5078,5404
E02006675,"Whaddon, Whiteparish & Winterslow",358,184,515,310,330,369,416,515,642,743,690,556,617,454,554,6711,6895,7253
E02006676,"Tisbury, Donhead & Tollard Royal",299,116,358,228,230,282,341,375,454,583,535,503,529,372,493,5283,5399,5698
E02006677,Downton & Morgan's Vale,371,179,485,307,358,380,479,481,636,680,656,548,603,488,681,6782,6961,7332
E02006678,Melksham North,365,165,598,516,534,448,426,523,605,577,469,389,429,397,399,6310,6475,6840
E02006679,"Bowerhill, Atworth & Whitley",650,318,904,678,721,750,705,859,959,933,797,762,693,564,681,10006,10324,10974
E02006680,Melksham South,315,135,513,471,500,382,415,455,552,574,525,463,462,388,665,6365,6500,6815
E02006681,"Winsley, Westwood & Holt",288,134,377,235,252,306,365,422,476,497,460,462,471,405,456,5184,5318,5606
E02006682,Bradford-on-Avon,524,218,569,482,564,640,732,739,762,801,747,744,809,594,899,9082,9300,9824
E02006683,"Staverton, Hilperton & Semington",414,198,624,427,505,503,512,554,726,621,541,417,428,338,359,6555,6753,7167
E02006684,Trowbridge North,298,123,611,645,657,604,436,464,521,475,389,360,353,274,378,6167,6290,6588
E02006685,Trowbridge East,519,257,750,645,810,849,785,708,743,622,550,509,544,382,573,8470,8727,9246
E02006686,Trowbridge West,256,114,486,359,395,371,291,341,438,399,365,295,313,226,293,4572,4686,4942
E02006687,Trowbridge South East,399,189,664,607,664,614,496,550,680,570,530,425,370,266,256,6692,6881,7280
E02006688,Trowbridge South,240,130,438,396,425,379,388,398,451,449,343,310,302,222,307,4808,4938,5178
E02006689,"Steeple Ashton, North Bradley & Southwick",335,145,435,342,366,372,356,432,490,513,528,441,484,423,445,5627,5772,6107
E02006690,Dilton Marsh & Bratton,296,152,453,334,339,369,384,422,528,611,569,511,552,434,486,5992,6144,6440
E02006691,Westbury,730,368,1079,985,1038,995,862,1034,1114,1034,858,701,683,584,747,11714,12082,12812
E02006692,Warminster East,230,111,545,444,478,481,397,342,387,350,264,290,302,236,354,4870,4981,5211
E02006693,Warminster West & North,299,142,476,321,390,396,381,447,504,506,456,388,404,307,324,5300,5442,5741
E02006694,Warminster Central,296,205,491,350,372,350,271,371,436,509,505,384,462,392,556,5449,5654,5950
E02006695,Wylye Valley,315,163,422,246,259,281,329,393,533,630,574,469,520,447,567,5670,5833,6148
E02003172,Kinson East,302,165,466,388,444,441,413,400,487,445,480,362,423,303,395,5447,5612,5914
E02003173,Kinson West,257,121,420,385,507,484,422,414,492,501,482,440,488,346,569,5950,6071,6328
E02003174,Northbourne,386,184,560,449,548,570,560,545,590,654,573,521,517,425,584,7096,7280,7666
E02003175,Throop & Muscliffe,584,215,618,554,702,770,765,708,685,652,629,441,423,365,394,7706,7921,8505
E02003176,West Howe,450,197,712,513,583,551,540,473,531,542,453,347,293,234,281,6053,6250,6700
E02003177,Moordown,480,178,685,476,567,654,710,654,609,670,515,402,368,298,382,6990,7168,7648
E02003178,East Howe & Ensbury Park,445,213,870,559,610,651,593,606,630,576,512,415,448,338,448,7256,7469,7914
E02003179,Townsend & Strouden,363,169,514,370,399,502,499,490,477,472,403,362,368,295,395,5546,5715,6078
E02003180,Winton,405,159,1936,868,838,757,726,568,590,520,429,299,287,185,278,8281,8440,8845
E02003181,Queens Park,481,226,884,588,654,772,732,714,698,638,481,420,434,293,394,7702,7928,8409
E02003182,Littledown,323,181,541,405,441,495,562,510,467,497,438,350,386,285,360,5737,5918,6241
E02003183,Talbot & Branksome Woods,307,166,1009,515,472,470,462,479,494,491,458,374,395,343,438,6400,6566,6873
E02003184,Charminster,339,154,1204,803,899,876,801,606,539,497,346,288,227,157,263,7506,7660,7999
E02003185,Iford,402,173,565,445,496,569,676,624,639,581,490,374,364,256,324,6403,6576,6978
E02003186,Springbourne & Queen's Park,499,221,1084,909,1076,1056,940,721,699,634,440,326,285,174,205,8549,8770,9269
E02003187,Boscombe East,482,261,939,790,856,931,924,822,775,674,585,469,415,288,379,8847,9108,9590
E02003188,Central Bournemouth,244,102,3778,1958,1780,1346,1085,741,638,576,542,496,459,341,573,14313,14415,14659
E02003189,Southbourne West,325,143,591,505,596,681,670,681,637,694,562,502,553,390,717,7779,7922,8247
E02003190,Boscombe West,342,123,807,1074,1329,1346,1125,984,881,818,586,473,386,219,373,10401,10524,10866
E02003191,East Southbourne & Hengistbury Head,293,167,458,332,413,509,527,531,641,612,594,598,701,575,907,7398,7565,7858
E02003192,East Cliff,291,109,3955,1804,1664,1397,1060,782,647,608,512,434,451,369,569,14252,14361,14652
E02003194,Merley,489,323,401,247,269,347,336,429,404,447,457,456,526,481,506,5306,5629,6118
E02003195,Bearwood,306,110,429,438,478,450,403,355,426,412,338,353,302,215,289,4888,4998,5304
E02003196,Broadstone,527,266,731,430,416,446,566,668,808,971,801,702,764,647,1123,9073,9339,9866
E02003197,Canford Heath West,376,160,479,384,448,465,452,440,477,567,503,437,458,248,284,5642,5802,6178
E02003198,Canford Heath East,434,164,548,477,648,568,534,502,526,571,455,359,353,314,344,6199,6363,6797
E02003199,Creekmoor,410,211,614,561,657,641,587,579,755,690,669,572,577,432,641,7975,8186,8596
E02003200,Rossmore,547,238,872,636,846,797,724,703,742,723,617,551,554,431,548,8744,8982,9529
E02003201,Newtown,539,239,840,852,1004,932,854,758,843,840,637,558,490,411,498,9517,9756,10295
E02003202,Branksome East,242,103,930,436,507,504,472,405,477,451,387,348,350,259,339,5865,5968,6210
E02003203,Branksome West,328,153,510,509,635,677,654,540,633,558,486,379,371,240,308,6500,6653,6981
E02003204,Oakdale East,457,202,612,566,636,629,661,638,777,650,586,492,506,416,622,7791,7993,8450
E02003205,Oakdale West,417,223,590,508,522,601,566,586,659,686,578,498,563,397,512,7266,7489,7906
E02003206,Penn Hill,511,238,703,600,671,767,776,855,888,849,642,522,561,403,510,8747,8985,9496
E02003207,Hamworthy West,409,177,654,658,811,657,539,489,569,534,414,335,363,315,318,6656,6833,7242
E02003208,Poole Town,365,174,1021,1041,1137,956,753,773,748,786,715,584,662,509,865,10550,10724,11089
E02003209,Hamworthy East,294,135,474,403,456,466,475,400,550,521,505,450,430,323,346,5799,5934,6228
E02003210,Parkstone,407,206,554,458,580,628,699,637,757,736,636,587,656,553,902,8383,8589,8996
E02003211,"Branksome Park, Canford Cliffs & Sandbanks",229,119,389,334,366,412,437,424,582,665,663,692,876,835,1466,8141,8260,8489
E02004236,Burton & Airport,248,113,401,309,327,329,353,345,454,493,494,476,543,405,543,5472,5585,5833
E02004237,Jumpers Common & Fairmile,429,225,679,369,381,461,550,614,660,602,534,442,555,448,643,6938,7163,7592
E02004238,Highcliffe & Walkford,247,132,406,304,258,304,352,381,504,511,533,550,840,724,1193,6860,6992,7239
E02004239,West Highcliffe,250,132,326,273,278,261,339,355,440,442,459,442,579,499,689,5382,5514,5764
E02004240,Somerford,306,175,535,437,488,447,380,394,488,518,383,335,290,222,268,5185,5360,5666
E02004241,Christchurch Town,485,230,563,503,585,620,620,700,651,673,619,534,639,537,927,8171,8401,8886
E02004242,Mudeford,207,102,304,232,261,280,331,320,414,524,551,603,644,621,794,5879,5981,6188
E02006883,Westbourne,92,41,367,580,723,646,503,406,392,348,329,314,283,298,599,5788,5829,5921
E02006885,West Cliff,172,74,588,912,1063,918,737,590,578,565,477,432,473,393,620,8346,8420,8592
E02004243,Alderholt & Sixpenny Handley,323,159,416,319,328,346,330,438,547,572,575,468,498,341,358,5536,5695,6018
E02004244,East Verwood,324,145,511,393,503,452,426,500,563,561,573,482,550,471,663,6648,6793,7117
E02004245,West Verwood,390,172,556,371,392,428,420,469,571,581,523,465,552,438,619,6385,6557,6947
E02004246,St Leonards,266,125,443,318,306,321,377,376,549,611,667,708,917,680,874,7147,7272,7538
E02004247,Sturminster Marshall & Crichel,290,128,396,236,249,304,351,389,518,594,579,496,492,332,355,5291,5419,5709
E02004248,West Moors,189,103,384,284,352,305,246,329,492,541,594,593,802,719,1085,6726,6829,7018
E02004249,Colehill,269,149,396,298,295,318,372,392,457,488,448,424,500,350,412,5150,5299,5568
E02004250,Ferndown Town,301,135,491,399,383,379,353,375,451,529,578,593,760,631,1104,7026,7161,7462
E02004251,Ferndown West & Canford Bottom,261,119,353,300,356,343,364,369,464,533,483,442,538,440,586,5571,5690,5951
E02004252,Wimborne Minster,342,160,495,486,500,421,443,454,533,591,507,478,538,490,772,6708,6868,7210
E02004253,Parley & Hampreston,356,173,528,394,436,429,498,491,673,753,771,729,878,798,1323,8701,8874,9230
E02004254,Corfe Mullen,506,250,770,533,576,611,677,669,774,813,755,675,730,561,636,8780,9030,9536
E02004255,Gillingham,337,147,523,377,382,387,429,463,598,583,553,492,580,456,731,6554,6701,7038
E02004256,"Gillingham Outer, Bourton & Motcombe",540,207,617,397,506,504,497,579,722,808,757,683,657,543,652,7922,8129,8669
E02004257,Shaftesbury,475,241,626,570,605,582,509,573,638,654,625,531,548,426,700,7587,7828,8303
E02004258,Sturminster Newton & Stalbridge,430,225,630,446,529,547,502,625,762,847,850,820,908,699,1013,9178,9403,9833
E02004259,Child Okeford & Iwerne Minster,406,246,479,368,356,362,384,412,528,555,616,566,595,481,558,6260,6506,6912
E02004260,Blandford Outer & Tarrants,738,516,924,468,557,570,550,501,554,581,566,539,571,438,441,7260,7776,8514
E02004261,Blandford Forum Town,475,202,630,591,665,680,675,624,718,773,662,625,682,500,718,8543,8745,9220
E02004262,"Milborne, Winterborne & Okeford Fitzpaine",388,262,570,335,386,362,372,447,677,825,708,684,676,473,483,6998,7260,7648
E02004263,Bere Regis & Lytchett Matravers,292,126,357,263,358,347,348,358,461,461,482,420,460,355,393,5063,5189,5481
E02004264,Upton & Lytchett Minster,423,190,577,520,553,524,507,529,627,697,613,551,605,473,580,7356,7546,7969
E02004265,"Wareham, Sandford & Holton Heath",350,167,494,423,415,425,424,507,579,726,694,635,726,573,788,7409,7576,7926
E02004266,"Bovington, Wool & Lulworth",379,226,706,567,591,583,547,523,543,606,585,491,521,437,442,7142,7368,7747
E02004267,Corfe Castle & Langton Matravers,186,93,290,192,224,221,227,266,383,491,469,470,509,386,458,4586,4679,4865
E02004268,Swanage,357,176,554,397,472,462,446,491,631,791,859,802,857,738,981,8481,8657,9014
E02004269,Sherborne,888,524,642,356,389,372,390,423,530,596,594,599,692,669,1115,7367,7891,8779
E02004270,"Yetminster, Bradford Abbas & Longburton",423,246,600,397,407,413,385,501,660,789,792,697,757,602,776,7776,8022,8445
E02004271,"Beaminster, Maiden Newton & Halstock",393,199,595,439,459,443,486,557,788,862,937,885,947,730,875,9003,9202,9595
E02004272,"Charlton Down, Cerne Abbas & Puddletown",555,261,704,546,588,581,628,762,1045,1126,1039,862,970,758,881,10490,10751,11306
E02004273,"Lyme Regis, Charmouth & Marshwood Vale",297,148,437,242,229,258,298,376,524,690,725,615,703,568,799,6464,6612,6909
E02004274,Bridport North,275,123,404,266,324,292,337,353,454,536,533,535,579,436,569,5618,5741,6016
E02004275,Burton Bradstock & Chideock,304,151,386,310,345,326,394,413,506,696,744,765,726,554,627,6792,6943,7247
E02004276,Bridport South & West Bay,190,87,296,252,274,265,234,284,381,450,489,519,570,464,595,5073,5160,5350
E02004277,Dorchester West & Poundbury,530,253,894,808,864,709,740,805,850,928,796,726,893,743,1423,11179,11432,11962
E02004278,Dorchester East,464,216,622,449,468,496,513,628,716,725,628,574,620,505,620,7564,7780,8244
E02004279,"Owermoigne, Broadmayne & Winterbourne",327,159,482,370,405,395,436,461,613,716,702,662,715,510,549,7016,7175,7502
E02004280,Chickerell & Chesil Bank,344,183,509,392,451,470,462,490,614,686,725,617,631,509,650,7206,7389,7733
E02004281,Broadwey & Littlemoor,369,166,558,486,527,499,454,458,621,614,552,478,445,331,328,6351,6517,6886
E02004282,Preston & Lodmoor,311,128,482,333,349,356,397,469,626,705,727,791,959,759,1033,7986,8114,8425
E02004283,Westham North & Radipole,462,245,664,426,493,534,536,513,662,711,709,603,640,521,642,7654,7899,8361
E02004284,"Weymouth Town, Melcombe Regis & Rodwell",328,161,653,694,728,631,626,612,780,862,798,733,717,527,723,9084,9245,9573
E02004285,Westham South,306,148,550,479,556,512,434,493,562,648,559,472,488,370,495,6618,6766,7072
E02004286,Weymouth West,242,119,378,267,259,260,264,348,414,414,383,356,345,238,336,4262,4381,4623
E02004287,Wyke Regis,290,129,437,246,293,300,308,360,437,501,403,386,444,302,343,4760,4889,5179
E02004288,Underhill & The Grove,241,132,610,480,489,467,403,434,512,549,475,361,342,225,217,5564,5696,5937
E02004289,Southwell & Weston,316,150,473,406,429,363,435,395,539,608,590,553,544,441,395,6171,6321,6637
E02004129,"Dunkesewell, Upottery & Stockland",254,105,298,231,252,276,288,332,483,543,490,460,481,426,477,5037,5142,5396
E02004130,Honiton North & East,232,129,361,317,344,307,287,383,411,395,451,412,474,419,665,5226,5355,5587
E02004131,Honiton South & West,212,108,339,324,311,289,270,367,418,415,389,334,381,312,482,4631,4739,4951
E02004132,Feniton & Whimple,432,208,487,410,430,482,513,564,699,755,708,674,655,503,532,7412,7620,8052
E02004133,Axminster,368,198,647,534,538,536,544,583,696,731,665,701,732,665,773,8345,8543,8911
E02004134,"Cranbrook, Broadclyst & Stoke Canon",800,350,1102,1257,1616,1492,1148,986,997,890,769,605,557,404,532,12355,12705,13505
E02004135,"Kilmington, Colyton & Uplyme",339,165,461,278,307,288,338,421,639,723,767,700,811,661,850,7244,7409,7748
E02004136,Ottery St Mary & West Hill,516,248,566,378,432,446,515,646,734,738,633,591,737,534,807,7757,8005,8521
E02004137,"Sidbury, Offwell & Beer",208,89,298,180,186,212,236,262,392,499,460,476,556,449,533,4739,4828,5036
E02004138,Seaton,232,99,375,260,268,260,283,403,502,550,583,659,866,737,1149,6895,6994,7226
E02004139,Sidmouth Sidford,291,138,392,259,303,303,319,345,536,521,521,488,630,595,750,5962,6100,6391
E02004140,Sidmouth Town,143,75,229,144,163,157,192,208,273,382,414,484,597,506,1033,4782,4857,5000
E02004141,"Poppleford, Otterton & Woodbury",252,135,385,259,270,321,349,370,462,512,470,491,494,394,487,5264,5399,5651
E02004142,"Clyst, Exton & Lympstone",251,168,1102,612,515,448,440,355,420,452,441,436,429,353,414,6417,6585,6836
E02004143,Exmouth Brixington,260,129,356,286,322,349,378,357,455,479,488,445,502,426,511,5354,5483,5743
E02004144,Exmouth Halsdon,321,170,402,295,311,361,367,416,538,461,486,537,586,502,574,5836,6006,6327
E02004145,Budleigh Salterton,216,107,263,185,195,203,250,319,393,427,478,579,654,619,901,5466,5573,5789
E02004146,Exmouth Withycombe Raleigh,379,151,569,416,425,468,502,489,563,609,480,453,489,322,414,6199,6350,6729
E02004147,Exmouth Town,309,127,580,507,508,516,483,529,583,536,477,418,405,258,361,6161,6288,6597
E02004148,Exmouth Littleham,323,144,412,331,369,326,361,454,490,583,608,611,731,674,1177,7127,7271,7594
E02004149,Pennsylvania & University,267,192,8180,1595,585,474,443,437,410,438,429,438,463,345,423,14660,14852,15119
E02004150,Mincinglake & Beacon Heath,323,144,1131,546,520,527,467,406,479,417,377,305,263,199,283,5920,6064,6387
E02004151,Pinhoe & Whipton North,553,236,772,686,814,800,702,701,694,712,521,475,493,377,631,8378,8614,9167
E02004152,St James's Park & Hoopern,123,60,3970,1124,703,536,436,349,319,281,246,209,181,155,196,8705,8765,8888
E02004153,Exwick & Foxhayes,365,164,619,579,617,619,576,515,521,528,403,344,332,251,250,6154,6318,6683
E02004154,Heavitree West & Polsloe,288,165,1517,826,800,743,576,481,510,391,313,250,262,173,322,7164,7329,7617
E02004155,Heavitree East & Whipton South,347,181,531,493,585,583,486,479,504,517,495,448,402,276,418,6217,6398,6745
E02004156,Central Exeter,207,133,5845,2118,1259,883,641,518,514,513,368,366,351,244,360,13980,14113,14320
E02004157,St Leonard's,284,120,1108,632,515,522,514,469,435,438,357,316,299,229,358,6192,6312,6596
E02004158,St Thomas East,377,148,694,745,866,762,674,566,607,533,436,321,306,228,328,7066,7214,7591
E02004159,Middlemoor & Sowton,619,311,872,848,1023,1011,860,904,946,751,650,554,600,436,492,9947,10258,10877
E02004160,St Thomas West,316,138,482,389,485,489,481,469,505,536,497,394,435,349,593,6104,6242,6558
E02004161,Wonford & St Loye's,498,225,737,674,746,739,600,629,649,610,489,360,369,291,475,7368,7593,8091
E02004162,Alphington & Marsh Barton,241,127,498,553,545,524,444,445,466,496,430,378,362,320,499,5960,6087,6328
E02004163,Countess Wear & Topsham,380,198,550,454,577,567,546,509,604,577,524,532,607,497,664,7208,7406,7786
E02004164,"Bampton, Holcombe & Westleigh",302,158,389,298,292,341,345,423,530,649,601,546,537,424,511,5886,6044,6346
E02004165,Tiverton North & Outer,404,174,643,505,510,553,471,524,652,660,605,578,617,532,712,7562,7736,8140
E02004166,Uffculme & Hemyock,386,171,399,277,277,374,392,469,549,544,533,465,477,392,393,5541,5712,6098
E02004167,Tiverton East,552,301,679,453,495,514,438,463,491,476,402,366,340,291,395,5803,6104,6656
E02004168,Tiverton West,315,130,490,399,509,477,409,379,451,437,376,348,380,262,370,5287,5417,5732
E02004169,"Willand, Sampford Peverell & Halberton",375,186,520,375,436,437,501,495,597,610,564,460,481,364,470,6310,6496,6871
E02004170,Cullompton,399,190,617,641,658,658,565,594,633,647,550,490,479,375,469,7376,7566,7965
E02004171,"Bradninch, Silverton & Thorverton",435,196,575,395,492,491,548,604,651,723,590,574,571,436,495,7145,7341,7776
E02004172,"Bow, Lapford & Yeoford",313,133,423,301,331,306,339,375,558,632,578,482,491,365,388,5569,5702,6015
E02004173,"Morchard Bishop, Copplestone & Newton St Cyres",387,180,465,355,380,393,397,445,616,677,613,559,578,382,484,6344,6524,6911
E02004174,Crediton,397,178,568,550,522,532,485,523,586,551,484,452,515,390,544,6702,6880,7277
E02004175,Ilfracombe East,264,120,390,352,338,317,355,373,449,477,442,371,344,279,345,4832,4952,5216
E02004176,Lynton & Combe Martin,236,105,414,263,305,236,299,348,504,566,537,491,522,369,408,5262,5367,5603
E02004177,Ilfracombe West,302,152,439,381,380,325,356,389,479,469,454,414,440,300,370,5196,5348,5650
E02004178,"Woolacombe, Georgeham & Croyde",269,122,326,265,230,323,370,415,427,473,389,374,419,324,326,4661,4783,5052
E02004179,Braunton,431,213,695,605,630,616,652,610,673,595,565,491,577,532,749,7990,8203,8634
E02004180,"Bratton Fleming, Goodleigh & Kings Heanton",310,176,405,316,333,329,329,448,517,570,560,496,463,387,447,5600,5776,6086
E02004181,Barnstaple Pilton,290,132,411,384,416,395,366,372,430,417,389,335,384,263,416,4978,5110,5400
E02004182,Barnstaple Central,303,144,495,547,512,487,413,386,494,449,420,338,313,273,382,5509,5653,5956
E02004183,Barnstaple Sticklepath,247,121,402,363,374,312,343,353,439,487,435,361,481,415,537,5302,5423,5670
E02004184,Barnstaple South,466,230,713,572,627,559,567,526,675,661,562,420,440,275,375,6972,7202,7668
E02004185,Fremington & Instow,273,106,368,280,368,313,298,341,441,579,620,497,580,531,652,5868,5974,6247
E02004186,Roundswell & Landkey,449,231,674,648,681,633,602,643,722,822,678,579,612,500,586,8380,8611,9060
E02004187,South Molton,536,284,718,561,620,584,525,618,738,895,852,759,810,598,780,9058,9342,9878
E02004188,"Bishop's Nympton, Witheridge & Chulmleigh",312,159,411,314,294,278,319,424,560,685,649,596,570,496,542,6138,6297,6609
E02004189,Woolwell & Lee Mill,286,137,394,336,416,339,346,392,504,558,492,400,375,266,292,5110,5247,5533
E02004190,South Brent & Cornwood,377,209,576,452,471,433,473,516,663,816,755,620,676,462,520,7433,7642,8019
E02004191,Totnes Town,404,226,617,493,586,577,603,637,749,750,679,652,655,479,621,8098,8324,8728
E02004192,"Marldon, Stoke Gabriel & Kingswear",298,144,365,299,341,354,416,460,549,704,727,684,694,564,560,6717,6861,7159
E02004193,Ivybridge,631,299,842,656,711,714,652,745,943,957,833,706,715,533,652,9659,9958,10589
E02004194,Loddiswell & Dartington,368,155,463,320,443,459,469,458,565,672,615,601,528,348,458,6399,6554,6922
E02004195,Dartmouth,169,91,504,336,297,304,251,291,378,428,444,424,432,362,467,4918,5009,5178
E02004196,"Yealmpton, Modbury & Aveton Gifford",397,152,452,317,357,396,486,477,591,694,694,622,691,494,538,6809,6961,7358
E02004197,"Wembury, Brixton & Newton Ferrers",292,142,402,293,307,361,408,417,505,603,573,537,597,548,635,6186,6328,6620
E02004198,Kingsbridge,302,146,422,307,340,367,341,384,472,508,489,410,455,395,586,5476,5622,5924
E02004199,"Chillington, Torcross & Stoke Fleming",206,101,287,208,207,222,267,284,395,507,553,508,616,466,575,5095,5196,5402
E02004200,"Salcombe, Malborough & Thurlestone",184,86,314,204,230,260,239,269,334,409,491,424,466,387,462,4489,4575,4759
E02004201,"Tedburn, Shillingford & Higher Ashton",199,111,290,192,223,283,302,323,399,468,507,477,492,413,446,4815,4926,5125
E02004202,Starcross & Exminster,377,174,559,469,530,577,581,546,684,681,631,552,589,457,529,7385,7559,7936
E02004203,"Moretonhampstead, Lustleigh & East Dartmoor",227,126,334,243,244,314,324,338,439,604,492,487,547,371,482,5219,5345,5572
E02004204,Chudleigh & Bovey Tracey,466,226,614,473,587,533,519,644,756,801,781,713,659,573,704,8357,8583,9049
E02004205,Dawlish North,369,185,546,443,469,513,472,528,669,703,743,736,705,505,551,7583,7768,8137
E02004206,Dawlish South,222,103,377,307,310,316,318,363,485,627,595,591,614,541,732,6176,6279,6501
E02004207,Heathfield & Liverton,293,142,413,335,364,365,372,399,520,575,474,429,497,411,494,5648,5790,6083
E02004208,Teignmouth North,393,171,519,324,360,401,432,512,613,673,682,675,776,570,623,7160,7331,7724
E02004209,Kingsteignton,405,204,646,538,645,595,514,589,704,757,630,483,552,469,572,7694,7898,8303
E02004210,Teignmouth South,289,108,498,367,382,414,398,435,479,528,522,460,450,346,587,5866,5974,6263
E02004211,Bishopsteignton & Shaldon,254,132,349,221,246,282,345,357,470,550,551,644,698,492,702,5907,6039,6293
E02004212,"Newton Abbot, Highweek",292,137,444,375,388,359,330,409,471,466,410,350,380,265,352,4999,5136,5428
E02004213,"Ogwell, Mile End & Teigngrace",387,167,580,699,817,791,663,564,635,616,513,490,436,297,371,7472,7639,8026
E02004214,"Newton Abbot, Town Centre",255,122,455,508,497,418,374,379,459,451,358,307,315,239,293,5053,5175,5430
E02004215,"Newton Abbot, Broadlands & Wolborough",279,137,491,381,425,371,357,350,485,465,416,359,351,265,471,5187,5324,5603
E02004216,"Newton Abbot, Milber & Buckland",248,111,362,284,360,343,296,291,387,492,462,405,401,336,417,4836,4947,5195
E02004217,Ashburton & Buckfastleigh,376,197,543,360,418,443,492,520,635,721,520,546,555,463,486,6702,6899,7275
E02004218,Kingskerswell,261,129,380,313,374,294,327,322,460,546,524,441,488,381,437,5287,5416,5677
E02004219,Ipplepen & Broadhempston,244,127,334,255,243,232,279,331,434,496,493,431,457,436,489,4910,5037,5281
E02004220,Appledore & Northam North,208,97,314,238,300,283,367,338,408,499,537,520,550,470,541,5365,5462,5670
E02004221,Westward Ho! & Northam South,205,88,333,237,271,269,297,372,455,480,512,524,661,516,725,5652,5740,5945
E02004222,Bideford North,297,171,538,325,373,387,317,380,501,513,448,378,388,288,336,5172,5343,5640
E02004223,Bideford South & East,641,294,972,815,902,805,797,799,940,945,940,724,782,529,596,10546,10840,11481
E02004224,Hartland Coast,256,131,387,284,292,267,310,364,515,634,530,550,577,424,517,5651,5782,6038
E02004225,Great Torrington,292,132,410,342,359,323,323,344,467,391,401,340,415,291,435,4841,4973,5265
E02004226,Winkleigh & High Bickington,294,119,375,322,330,291,329,433,583,690,732,669,656,500,557,6467,6586,6880
E02004227,"Holsworthy, Bradworthy & Welcombe",454,211,705,512,501,497,504,547,819,871,832,776,803,583,639,8589,8800,9254
E02004228,"Shebbear, Cookworthy & Broadheath",303,164,455,298,333,353,357,411,582,726,740,642,652,498,517,6564,6728,7031
E02004229,"Hatherleigh, Exbourne & North Tawton",422,200,561,496,604,570,573,588,727,821,791,662,658,538,613,8202,8402,8824
E02004230,Okehampton,392,193,560,439,439,464,481,512,568,580,465,460,500,433,564,6465,6658,7050
E02004231,"Chagford, Princetown & Dartmoor",251,134,408,340,428,409,389,466,565,698,634,560,550,414,455,6316,6450,6701
E02004232,"Lifton, Lamerton & Bridestowe",291,146,401,284,343,306,310,402,583,671,621,594,541,397,466,5919,6065,6356
E02004233,Tavistock,678,391,803,555,637,617,666,726,918,1003,989,907,1028,778,1084,10711,11102,11780
E02004234,Horrabridge & Mary Tavy,294,118,325,230,213,243,292,353,481,546,614,549,561,423,515,5345,5463,5757
E02004235,"Bere Alston, Buckland Monachorum & Yelverton",297,134,403,209,249,297,314,352,502,615,557,507,612,446,552,5615,5749,6046
E02004600,Swindon Village & Wyman's Brook,228,90,355,388,460,495,412,342,382,401,404,340,319,232,254,4784,4874,5102
E02004601,Prestbury & Racecourse,230,93,301,252,331,379,370,320,339,444,410,382,449,372,560,4909,5002,5232
E02004602,Springbank,337,165,561,521,668,655,484,414,376,414,396,314,292,228,281,5604,5769,6106
E02004603,St Paul's,261,110,2009,877,833,724,490,426,421,375,333,292,276,200,243,7499,7609,7870
E02004604,Arle & Hesters Way,479,206,749,668,790,761,644,507,555,542,401,363,232,181,279,6672,6878,7357
E02004605,Oakley,354,121,510,449,465,436,443,379,382,423,363,288,247,202,221,4808,4929,5283
E02004606,Alstone & St Mark's,395,178,1070,1154,1079,1040,781,660,700,661,560,403,391,241,449,9189,9367,9762
E02004607,Pittville & Fairview,272,121,915,1033,979,843,745,634,684,717,570,476,472,326,450,8844,8965,9237
E02004608,Lansdown & Montpellier,806,569,1152,1127,960,727,604,630,670,701,562,451,461,404,671,9120,9689,10495
E02004609,Benhall & The Reddings,297,146,515,445,438,493,543,497,538,542,499,377,398,334,516,6135,6281,6578
E02004610,The Park & Warden Hill,427,244,864,571,481,455,407,487,528,603,483,419,515,434,697,6944,7188,7615
E02004611,Battledown & Charlton Kings,834,376,832,583,680,879,908,1004,1000,882,690,524,561,428,682,9653,10029,10863
E02004612,Hatherley,429,191,630,443,559,589,640,638,677,745,645,523,537,440,659,7725,7916,8345
E02004613,Charlton Park,418,214,405,259,264,340,412,483,524,573,435,411,412,366,545,5429,5643,6061
E02004614,Leckhampton,264,133,307,196,243,394,408,397,454,437,362,344,369,253,448,4612,4745,5009
E02004615,"Willersley, Chipping Campden & Blockley",409,191,494,338,398,408,454,498,742,800,749,709,694,638,768,7690,7881,8290
E02004616,Moreton & Stow-on-the-Wold,376,174,588,513,611,558,572,613,723,832,726,688,721,603,908,8656,8830,9206
E02004617,Bourton-on-the-Water & Vale,473,223,584,459,506,567,618,692,697,792,682,590,607,526,632,7952,8175,8648
E02004618,"Sandywell, Ermin & Chedworth",365,163,546,310,373,379,418,480,621,704,601,580,533,356,374,6275,6438,6803
E02004619,"Northleach, Coln Valley & Ampneys",300,161,454,339,320,367,393,497,646,674,669,549,538,462,464,6372,6533,6833
E02004620,Cirencester East & Stratton,426,228,645,473,501,572,579,572,700,646,570,506,544,353,420,7081,7309,7735
E02004621,Cirencester Central,197,94,927,525,440,373,352,390,463,465,368,338,392,354,748,6135,6229,6426
E02004622,Cirencester South,306,139,589,525,502,469,460,463,485,508,436,393,425,340,466,6061,6200,6506
E02004623,Fairford & Lechlade,395,210,548,447,410,518,516,616,731,773,674,649,731,542,656,7811,8021,8416
E02004624,Kemble & South Cerney,336,135,463,299,352,421,454,460,581,651,565,452,436,363,412,5909,6044,6380
E02004625,Tetbury,452,250,680,550,644,610,609,684,757,828,770,709,697,561,683,8782,9032,9484
E02004626,"Dymock, Hartpury & Huntley",383,493,1302,453,419,461,466,511,719,850,778,683,732,539,662,8575,9068,9451
E02004627,Newent,266,98,453,406,464,401,348,370,461,471,434,393,451,361,449,5462,5560,5826
E02004628,"Mitcheldean, Drybrook & Ruardean",385,197,527,397,481,440,413,541,623,641,595,546,529,419,455,6607,6804,7189
E02004629,Cinderford,565,284,895,833,852,786,775,804,962,1023,840,851,771,572,692,10656,10940,11505
E02004630,"Longhope, Westbury & Blakeney",244,125,457,289,330,333,303,443,541,614,562,502,501,375,479,5729,5854,6098
E02004631,"Lydbrook, Newland & St Briavels",217,101,282,190,204,231,218,311,454,545,507,377,407,330,362,4418,4519,4736
E02004632,Coleford,516,232,734,586,672,600,579,625,832,864,784,717,748,574,734,9049,9281,9797
E02004633,"Bream, Pillowell & Yorkley",358,209,559,401,451,414,435,541,697,768,629,636,625,455,469,7080,7289,7647
E02004634,Lydney,435,219,810,726,775,644,560,600,860,870,738,652,735,567,720,9257,9476,9911
E02004635,Tidenham & Woolaston,323,153,633,492,474,514,427,447,549,560,540,502,560,407,504,6609,6762,7085
E02004636,Longlevens,333,168,692,461,477,468,454,479,620,648,577,461,463,366,457,6623,6791,7124
E02004637,Kingsholm & Wotton,399,165,955,704,765,677,660,683,615,614,559,432,424,326,576,7990,8155,8554
E02004638,Elmbridge,282,144,440,354,411,396,395,389,462,430,363,284,316,238,345,4823,4967,5249
E02004639,Central Gloucester & Hempsted,410,206,1324,1189,1198,982,801,671,721,667,567,420,387,351,525,9803,10009,10419
E02004640,Barton,600,252,962,739,872,818,711,615,644,557,448,315,205,179,238,7303,7555,8155
E02004641,Hucclecote,303,138,466,363,386,411,406,461,535,571,478,468,536,522,697,6300,6438,6741
E02004642,"Coney Hill, Barnwood & Abbeydale",740,345,1037,817,873,874,814,839,990,892,744,575,540,401,404,9800,10145,10885
E02004643,Tredworth,553,235,836,641,775,677,614,522,602,595,469,287,238,154,238,6648,6883,7436
E02004644,Podsmead & Linden,474,207,743,666,758,697,663,555,654,690,543,432,329,261,354,7345,7552,8026
E02004645,Abbeymead & Abbeydale,407,208,616,546,642,595,530,575,719,733,708,521,516,371,404,7476,7684,8091
E02004646,Matson & Robinswood,449,205,704,623,723,693,575,535,635,639,558,470,427,311,378,7271,7476,7925
E02004647,Tuffley,317,153,488,400,387,376,308,334,472,478,432,357,371,281,438,5122,5275,5592
E02004648,Lower Tuffley,246,113,359,319,342,345,287,291,385,414,400,329,436,408,431,4746,4859,5105
E02004649,Quedgeley North,361,187,579,557,572,554,552,523,591,566,438,312,237,160,154,5795,5982,6343
E02004650,Quedgeley South,908,377,1168,1126,1309,1348,1152,949,909,754,586,480,383,281,339,10784,11161,12069
E02004651,Upton St Leonards & Hardwicke,565,227,781,774,932,937,811,699,732,693,578,471,523,329,367,8627,8854,9419
E02004652,"Painswick, Bisley & Eastcombe",322,137,359,211,245,291,365,451,540,570,577,517,551,450,655,5782,5919,6241
E02004653,"Frampton, Whitminster & Eastington",366,170,515,418,447,477,478,503,665,655,612,516,524,374,484,6668,6838,7204
E02004654,Ebley & Randwick,557,278,792,602,718,681,721,803,940,907,773,659,744,528,665,9533,9811,10368
E02004655,Stonehouse,457,293,603,545,594,467,513,479,647,606,512,499,467,319,452,6703,6996,7453
E02004656,Stroud Town,536,255,889,756,739,744,788,805,948,994,781,697,617,378,577,9713,9968,10504
E02004657,Rodborough & Thrupp,381,173,437,339,363,397,411,570,621,620,519,421,424,329,359,5810,5983,6364
E02004658,Chalford & Bussage,358,175,469,295,288,287,375,483,581,602,469,367,430,315,375,5336,5511,5869
E02004659,Leonard Stanley & Uley,312,144,456,348,379,403,410,430,525,567,582,532,508,392,498,6030,6174,6486
E02004660,Minchinhampton & Amberley,322,162,378,239,268,289,365,459,525,552,485,473,575,484,675,5767,5929,6251
E02004661,Cam,354,147,564,487,521,489,477,527,646,709,678,544,657,466,576,7341,7488,7842
E02004662,Berkeley & Sharpness,281,135,410,366,411,366,370,417,527,525,515,447,429,323,376,5482,5617,5898
E02004663,Nailsworth,321,139,399,321,405,386,407,473,495,514,543,465,468,326,404,5606,5745,6066
E02004664,Dursley,363,170,518,482,522,605,498,554,545,500,472,364,358,272,453,6143,6313,6676
E02004665,Wotton-under-Edge & Kingswood,433,210,669,442,472,470,531,653,713,664,636,569,592,477,544,7432,7642,8075
E02004666,Tewkesbury East & Ashchurch,627,318,921,771,921,850,857,888,963,882,642,659,563,437,505,9859,10177,10804
E02004667,Tewkesbury West & Twyning,421,210,685,624,737,648,681,614,812,887,820,731,809,639,832,9519,9729,10150
E02004668,Winchcombe & Washbourne,370,181,515,402,419,481,502,545,620,825,766,713,824,637,692,7941,8122,8492
E02004669,"Cleeve Hill, Gotherington & Apperley",363,163,467,307,359,399,429,515,570,637,590,522,561,432,502,6290,6453,6816
E02004670,Bishop's Cleeve,806,350,1057,980,1212,1156,1074,1053,1105,1121,887,782,819,715,1028,12989,13339,14145
E02004671,"Highnam, Longford & Norton",338,181,475,400,468,452,460,434,549,594,562,577,539,372,391,6273,6454,6792
E02004672,Churchdown & Innsworth,645,260,932,924,998,922,982,862,996,932,776,615,664,563,772,10938,11198,11843
E02004673,"Shurdington, Staverton & Witcombe",331,159,508,468,577,501,441,455,491,589,496,426,433,359,541,6285,6444,6775
E02004674,Brockworth & Coopers Edge,598,270,839,882,1092,1019,823,746,739,770,697,565,501,407,532,9612,9882,10480
E02006047,"Rode, Mells & Woodlands",386,209,592,399,414,491,543,646,799,878,642,618,658,496,521,7697,7906,8292
E02006048,"Stratton, Holcombe & Highbury",522,256,536,388,391,392,390,496,608,597,536,481,498,345,383,6041,6297,6819
E02006049,Frome North East,322,159,475,358,455,432,453,475,547,524,510,494,589,457,522,6291,6450,6772
E02006050,Frome North West,498,222,641,543,641,720,637,670,686,665,530,490,424,291,447,7385,7607,8105
E02006051,"Draycott, Westbury & Wookey",525,344,567,351,413,425,458,553,655,693,685,596,621,492,664,7173,7517,8042
E02006052,"Oakhill, Horrington & Chewton Mendip",378,156,511,449,452,406,429,523,706,714,599,540,531,452,566,6878,7034,7412
E02006053,Frome South & East,564,247,735,667,902,892,768,717,818,814,629,566,559,427,482,8976,9223,9787
E02006054,Wells Town,324,153,526,440,452,455,433,527,651,687,684,560,635,525,857,7432,7585,7909
E02006055,Shepton Mallet,442,192,689,672,788,719,643,544,702,728,562,477,475,333,404,7736,7928,8370
E02006056,Evercreech & Nunney,373,151,499,408,445,409,422,506,625,760,587,506,558,411,492,6628,6779,7152
E02006057,Glastonbury Town,372,152,513,450,450,512,506,586,794,739,655,611,565,399,467,7247,7399,7771
E02006058,Glastonbury West & Street South,847,725,701,413,450,453,498,568,668,577,603,510,562,411,521,6935,7660,8507
E02006059,"Pilton, Butleigh & Alhampton",316,177,460,326,295,287,357,443,609,719,631,549,558,402,442,6078,6255,6571
E02006060,Street Village,459,209,651,551,586,522,600,556,693,589,486,417,447,355,569,7022,7231,7690
E02006061,Cheddar & Axbridge,451,224,628,423,471,488,535,629,768,793,666,580,702,529,695,7907,8131,8582
E02006062,Berrow & Brent Knoll,426,230,689,430,483,507,541,672,851,1040,1001,966,996,754,994,9924,10154,10580
E02006063,Wedmore & Mark,349,192,485,266,254,290,361,427,610,704,578,533,585,444,482,6019,6211,6560
E02006064,Burnham-on-Sea,267,115,439,343,340,374,384,458,545,617,595,573,695,586,890,6839,6954,7221
E02006065,Highbridge,431,202,642,586,592,507,534,564,727,637,591,594,596,498,486,7554,7756,8187
E02006066,"Pawlett, Puriton & Woolavington",355,191,550,435,513,480,415,493,584,698,634,640,680,495,542,7159,7350,7705
E02006067,"Cannington, Combwich & Nether Stowey",312,143,452,356,345,334,353,391,532,672,596,580,538,443,557,6149,6292,6604
E02006068,Bridgwater North,470,199,699,615,697,614,479,510,572,575,448,334,338,211,298,6390,6589,7059
E02006069,Bridgwater Town,485,204,912,941,1096,985,823,771,793,702,586,425,423,257,383,9097,9301,9786
E02006070,Bridgwater East,357,154,597,743,780,684,543,500,637,580,487,414,444,331,389,7129,7283,7640
E02006071,Wembdon & Chilton Trinity,517,254,711,520,605,631,667,622,723,723,597,513,573,431,600,7916,8170,8687
E02006072,"Westonzoyland, Ashcott & Cossington",387,217,635,393,469,424,450,522,836,878,874,763,813,585,664,8306,8523,8910
E02006073,Bridgwater South,470,204,722,575,644,610,521,517,564,516,441,343,323,232,354,6362,6566,7036
E02006074,Stockmoor & North Petherton,573,242,760,747,907,873,734,729,816,892,704,565,609,437,539,9312,9554,10127
E02006075,"Bruton, Brewham & Cucklington",497,312,665,252,257,271,277,366,434,434,381,319,337,265,306,4564,4876,5373
E02006076,Castle Cary & Kenton Mandeville,386,207,612,405,451,420,402,557,695,810,795,716,769,599,778,8009,8216,8602
E02006077,Somerton,267,118,381,318,343,268,273,348,428,523,481,422,506,420,583,5294,5412,5679
E02006078,Langport & Long Sutton,262,139,391,296,311,309,320,387,497,546,503,500,549,355,454,5418,5557,5819
E02006079,"Wincanton, Cheriton & Charlton Horethorne",348,169,544,488,602,489,466,454,563,662,587,556,535,406,523,6875,7044,7392
E02006080,"Ilchester, Sparkford & Mudford",324,139,1036,810,820,687,539,478,505,543,458,388,426,334,363,7387,7526,7850
E02006081,Curry Rivel & Fivehead,272,145,365,260,279,256,300,337,431,521,512,453,496,364,428,5002,5147,5419
E02006082,"Templecombe, Hentsridge & Milborne Port",299,123,457,380,409,409,375,438,481,543,513,499,565,440,410,5919,6042,6341
E02006083,Martock,192,118,356,301,277,295,297,333,409,450,465,417,463,359,429,4851,4969,5161
E02006084,"South Petherton, Seavington & Kingsbury",307,141,393,284,348,364,342,408,593,649,656,663,669,494,627,6490,6631,6938
E02006085,Yeovil North East,350,153,498,561,597,557,462,419,486,483,437,415,465,325,346,6051,6204,6554
E02006086,Yeovil Lufton & Hollands,414,206,596,463,514,464,494,535,586,530,402,349,418,338,427,6116,6322,6736
E02006087,Yeovil Larkhill,341,148,444,435,500,435,383,385,419,390,324,253,264,224,314,4770,4918,5259
E02006088,Yeovil Milford Park,420,210,719,587,628,605,516,580,541,521,422,369,343,258,346,6435,6645,7065
E02006089,Yeovil Town,299,139,662,701,759,649,563,565,555,498,397,314,267,200,320,6450,6589,6888
E02006090,Yeovil Preston Plucknett,368,157,499,527,575,545,468,489,519,528,397,341,360,295,490,6033,6190,6558
E02006091,Ham Hill & Merriott,424,225,602,425,474,465,521,596,814,844,821,753,810,674,728,8527,8752,9176
E02006092,Yeovil South,259,134,429,369,419,421,371,403,486,482,427,438,509,340,359,5453,5587,5846
E02006093,Ilminster & Horton,362,141,540,428,513,472,468,506,605,673,628,551,708,583,788,7463,7604,7966
E02006094,Stoford & the Cokers,238,99,314,244,251,241,273,326,425,479,432,409,431,368,431,4624,4723,4961
E02006095,Crewkerne,342,151,498,410,425,453,454,519,621,664,565,573,643,517,670,7012,7163,7505
E02006096,Chard North & East,359,145,534,455,466,469,460,444,537,540,475,425,535,361,459,6160,6305,6664
E02006097,Chard West,332,160,526,445,501,487,447,434,531,491,453,408,411,312,533,5979,6139,6471
E02006098,Tatworth & Combe St Nicholas,312,145,401,269,328,317,330,412,543,709,689,667,695,533,574,6467,6612,6924
E02006099,Bishops Lydeard & Cotford St Luke,397,201,492,332,385,397,434,497,610,563,502,447,501,361,398,5919,6120,6517
E02006100,Taunton Rowbarton & Kingston,567,371,569,438,559,527,470,504,579,619,498,471,456,386,498,6574,6945,7512
E02006101,Wiveliscombe & Milverton,302,132,344,230,269,256,292,355,461,540,479,425,410,361,430,4852,4984,5286
E02006102,Taunton Pyrland & Priorswood,394,174,532,424,542,488,435,431,491,538,448,424,378,278,412,5821,5995,6389
E02006103,Ruishton & North Curry,385,170,478,319,351,396,442,529,641,636,560,591,652,502,606,6703,6873,7258
E02006104,Taunton Halcon & Monkton Heathfield,503,265,698,729,860,822,739,734,728,734,636,498,470,372,388,8408,8673,9176
E02006105,Taunton North Town,439,201,877,1089,1222,1108,899,743,819,725,608,555,470,351,490,9956,10157,10596
E02006106,Bishop's Hull & Norton Fitzwarren,488,236,903,926,962,923,767,712,746,698,607,510,489,372,510,9125,9361,9849
E02006107,Taunton Holway & Lambrook,476,229,694,578,677,700,603,559,555,602,487,473,433,294,413,7068,7297,7773
E02006108,Taunton Wilton,369,220,688,672,718,617,579,566,607,574,513,467,521,485,967,7974,8194,8563
E02006109,Taunton Galmington & Trull,402,178,458,384,442,470,488,542,575,580,520,486,565,503,707,6720,6898,7300
E02006110,Wellington North,470,206,728,691,742,729,619,651,738,701,638,551,573,401,552,8314,8520,8990
E02006111,"Wellington South, Rockwell Green & West Buckland",506,331,667,475,465,461,522,659,816,843,837,799,925,736,956,9161,9492,9998
E02006112,Dowslands & Blackdown,506,324,518,386,384,385,437,501,616,763,713,611,608,449,659,7030,7354,7860
E02006113,Minehead Town,260,138,559,395,433,419,415,383,512,567,543,497,598,508,837,6666,6804,7064
E02006114,Minehead Outer & Porlock,206,101,390,338,405,409,314,285,406,504,589,593,644,509,746,6132,6233,6439
E02006115,"Watchet, Washford & Carhampton",298,123,451,360,403,399,313,385,478,603,689,691,702,553,616,6643,6766,7064
E02006116,"Williton, Quantock & Stogursey",301,143,453,330,303,338,377,416,612,783,727,758,790,635,705,7227,7370,7671
E02006117,"Dunster, Dulverton & Exmoor",195,91,264,223,232,242,218,257,424,566,594,524,553,414,535,5046,5137,5332
E02002905,"Wigmore, Orleton & Brimfield",219,140,324,216,262,268,290,377,529,588,556,558,530,446,451,5395,5535,5754
E02002906,Leominster North,263,113,376,326,396,360,334,298,367,407,326,327,381,278,452,4628,4741,5004
E02002907,Leominster South,284,162,461,414,440,410,377,411,463,446,436,444,438,349,492,5581,5743,6027
E02002908,"Shobdon, Luston & Bodenham",346,194,487,385,399,375,432,517,687,845,800,771,793,600,666,7757,7951,8297
E02002909,Bromyard & Bishop's Frome,383,208,635,518,582,534,597,603,769,936,1003,978,939,665,819,9578,9786,10169
E02002910,"Kington, Eardisley & Staunton",295,153,431,366,404,387,352,445,576,697,690,697,623,523,705,6896,7049,7344
E02002911,"Credenhill, Weobley & Wellington",447,215,617,683,921,855,708,642,796,770,724,685,741,518,727,9387,9602,10049
E02002912,"Lugwardine, Withington & Moreton on Lugg",325,178,529,404,470,476,481,557,619,614,550,502,491,362,449,6504,6682,7007
E02002913,"Colwall, Cradley & Wellington Heath",240,114,309,239,236,286,292,325,470,494,564,531,534,446,480,5206,5320,5560
E02002914,Hereford North West,388,192,636,574,674,660,588,566,648,643,626,513,510,408,539,7585,7777,8165
E02002915,Hereford North East,364,165,573,500,569,527,441,462,530,601,536,424,421,421,712,6717,6882,7246
E02002916,Hereford Central,400,193,884,887,944,843,691,680,744,703,603,477,464,302,423,8645,8838,9238
E02002917,Hereford West,296,138,518,550,608,508,460,422,509,517,388,363,344,286,423,5896,6034,6330
E02002918,Hereford East,299,132,392,289,312,324,339,415,417,397,409,364,395,303,548,4904,5036,5335
E02002919,Hereford South,478,201,674,584,718,692,660,545,620,580,533,406,435,313,431,7191,7392,7870
E02002920,"Belmont, Madley & Clehonger",258,141,447,367,455,392,379,440,509,536,483,378,376,334,333,5429,5570,5828
E02002921,Hereford South West,437,194,657,579,730,654,543,515,546,522,440,334,322,181,232,6255,6449,6886
E02002922,"Fownhope, Tarrington & Marcle",311,150,443,303,325,291,326,420,522,625,570,529,521,367,465,5707,5857,6168
E02002923,Ledbury,415,217,642,531,635,572,581,579,752,726,642,582,743,659,899,8543,8760,9175
E02002924,Golden Valley,327,122,348,233,249,266,315,349,467,564,514,481,533,349,483,5151,5273,5600
E02002925,Kingstone & Kingsthorne,495,218,709,570,624,579,602,674,883,989,877,764,769,546,693,9279,9497,9992
E02002926,Ross-on-Wye,477,205,702,601,700,704,602,712,790,833,780,801,782,641,941,9589,9794,10271
E02002927,"Penyard, Llangarron & Goodrich",446,244,798,612,635,669,663,763,993,1222,1090,1063,969,810,860,11147,11391,11837
E02002928,Newport North,294,133,457,266,313,327,334,367,428,460,410,368,428,328,346,4832,4965,5259
E02002929,Edgemond & Church Aston,317,152,1468,410,320,338,329,420,562,569,432,406,433,373,414,6474,6626,6943
E02002930,Newport South,359,170,534,384,425,434,410,445,498,472,345,364,441,348,467,5567,5737,6096
E02002931,Muxton & Lilleshall,382,180,514,395,368,374,401,495,640,591,437,368,401,334,353,5671,5851,6233
E02002932,Donnington,552,228,764,591,742,723,652,644,711,554,428,374,356,272,313,7124,7352,7904
E02002933,Dothill & Shawbirch,366,165,607,494,518,463,420,507,703,695,592,451,451,373,497,6771,6936,7302
E02002934,Apley & Leegomery,327,163,454,387,422,411,430,404,526,500,447,413,339,207,234,5174,5337,5664
E02002935,Wrockwardine Wood & Trench,284,137,482,472,481,443,419,438,494,488,433,384,395,295,384,5608,5745,6029
E02002936,Hadley & Horton,650,293,964,947,1071,1005,891,817,741,642,492,357,318,215,256,8716,9009,9659
E02002937,"Ironbridge, Admaston & Higher Ercall",492,237,685,518,536,584,639,721,958,1024,832,675,654,557,622,9005,9242,9734
E02002938,Wellington East,474,266,821,555,578,592,502,523,496,480,418,369,328,227,277,6166,6432,6906
E02002939,Wellington West,317,162,522,534,508,499,436,505,550,505,462,393,441,358,486,6199,6361,6678
E02002940,St George's,258,131,407,408,370,398,353,383,471,475,394,328,329,250,315,4881,5012,5270
E02002941,Oakengates & Ketley,447,233,768,654,767,814,666,682,784,801,638,554,527,444,524,8623,8856,9303
E02002942,Priorslee,494,197,620,513,588,590,570,527,619,554,527,424,366,199,276,6373,6570,7064
E02002943,Horsehay & The Rock,990,437,1183,1361,1551,1501,1315,1178,1153,909,677,582,486,276,342,12514,12951,13941
E02002944,Malinslee,500,242,748,653,792,644,598,554,560,553,454,410,340,242,242,6790,7032,7532
E02002945,Hollinswood & Randlay,620,258,888,749,884,887,829,773,758,677,536,490,449,299,239,8458,8716,9336
E02002946,Dawley & Aqueduct,324,168,526,522,545,533,453,513,605,665,552,416,439,259,334,6362,6530,6854
E02002947,Brookside,451,184,640,532,616,559,519,471,522,453,369,353,323,237,210,5804,5988,6439
E02002948,Woodside,592,252,758,633,647,631,514,503,508,381,306,266,253,166,195,5761,6013,6605
E02002949,Madeley,221,126,426,358,370,330,305,371,459,443,421,384,405,251,301,4824,4950,5171
E02002950,Sutton Hill,389,164,491,415,487,467,362,369,430,394,342,309,313,235,274,4888,5052,5441
E02002951,Great Chell & Packmoor,405,185,585,422,502,449,467,492,550,650,537,521,531,328,454,6488,6673,7078
E02002952,Goldenhill & Sandyford,482,195,619,514,747,648,556,477,553,455,407,313,311,237,347,6184,6379,6861
E02002953,Bradeley & Chell Heath,434,190,555,466,541,467,438,461,557,476,424,432,482,370,388,6057,6247,6681
E02002954,Norton,451,194,592,545,657,578,449,485,655,600,510,467,396,326,416,6676,6870,7321
E02002955,Tunstall,467,238,776,659,773,744,660,588,542,450,328,283,220,182,231,6436,6674,7141
E02002956,Little Chell & Stanfield,566,272,823,651,766,667,586,598,719,625,589,407,418,286,374,7509,7781,8347
E02002957,Baddley & Milton,421,212,653,467,587,583,586,629,714,766,680,549,620,509,680,8023,8235,8656
E02002958,Smallthorne & Sneyd Green,453,183,612,546,677,706,575,511,579,534,495,412,337,304,428,6716,6899,7352
E02002959,Longport & Burslem Park,540,253,817,743,892,837,715,680,603,519,399,348,317,248,337,7455,7708,8248
E02002960,Birches Head,294,119,457,371,394,394,342,342,444,452,494,384,334,238,274,4920,5039,5333
E02002961,Cobridge & Central Forest,455,214,769,763,854,825,707,562,576,452,332,283,199,186,233,6741,6955,7410
E02002962,Abbey Hulton,465,225,635,584,666,592,464,459,553,534,455,364,337,250,345,6238,6463,6928
E02002963,Northwood,341,162,672,685,748,706,569,519,529,508,428,309,264,186,217,6340,6502,6843
E02002964,Townsend & Eaton Park,405,184,630,439,589,559,497,499,605,626,592,527,595,445,533,7136,7320,7725
E02002965,Hanley & Etruria,528,253,1340,923,978,915,761,597,491,351,306,250,171,131,162,7376,7629,8157
E02002966,Shelton & Joiner's Square,424,211,2029,1388,1459,1077,691,542,484,427,326,289,272,164,211,9359,9570,9994
E02002967,Bentilee & Ubberley,760,296,927,721,963,879,740,610,688,637,578,408,322,200,344,8017,8313,9073
E02002968,Basford & Hartshill,382,185,880,840,879,743,642,664,651,603,532,453,397,257,392,7933,8118,8500
E02002969,Boothen & Penkhull,359,178,1066,944,963,845,712,627,643,590,470,376,334,238,321,8129,8307,8666
E02002970,Fenton,388,173,657,675,708,605,524,560,603,577,430,391,358,275,299,6662,6835,7223
E02002971,Fen Park,207,105,368,332,405,353,373,299,396,391,357,331,307,188,151,4251,4356,4563
E02002972,Longton West & Sandford Hill,316,130,507,428,493,458,387,346,420,476,355,320,334,254,237,5015,5145,5461
E02002973,Oakhill & Trent Vale,446,205,735,582,663,648,538,600,632,505,445,346,323,224,291,6532,6737,7183
E02002974,Weston Coyney,263,130,363,349,422,427,332,322,393,450,413,389,393,310,466,5029,5159,5422
E02002975,Longton East,317,140,488,438,479,429,387,458,570,610,555,489,391,300,304,5898,6038,6355
E02002976,Hollybush & Blurton North,373,171,513,372,425,430,397,378,440,430,363,291,338,236,275,4888,5059,5432
E02002977,Dresden,260,136,377,328,340,303,324,346,386,415,416,389,388,372,478,4862,4998,5258
E02002978,Meir North,412,177,527,495,573,521,439,404,412,391,346,336,293,208,273,5218,5395,5807
E02002979,Florence,436,200,649,485,582,557,474,381,377,313,277,258,193,177,187,4910,5110,5546
E02002980,Hanford & Trentham West,282,122,350,274,336,360,387,377,434,443,439,408,445,374,560,5187,5309,5591
E02002981,Meir South & Lightwood,583,294,746,578,610,610,582,576,664,608,461,364,330,210,302,6641,6935,7518
E02002982,Newstead & Blurton South,538,251,680,587,744,698,643,591,548,459,429,427,312,202,227,6547,6798,7336
E02002983,Meir Park,238,128,370,271,298,327,328,336,448,415,370,386,350,300,276,4475,4603,4841
E02002984,Trentham East,229,117,321,265,319,344,331,366,415,433,419,419,454,313,363,4762,4879,5108
E02006008,Shifnal,469,208,597,596,693,706,631,679,814,746,636,534,544,453,557,8186,8394,8863
E02006009,Cosford & Albrighton,236,166,1250,661,513,543,419,436,466,502,420,331,414,357,589,6901,7067,7303
E02006010,Much Wenlock & Broseley,510,245,608,524,586,617,616,746,906,969,932,882,937,649,753,9725,9970,10480
E02006011,Bridgnorth West,229,136,363,245,252,307,316,371,456,435,377,355,433,393,560,4863,4999,5228
E02006012,Bridgnorth East,249,105,366,285,319,301,329,395,547,514,480,477,520,435,536,5504,5609,5858
E02006013,"Alveley, Claverley & Worfield",295,149,505,346,304,319,407,512,642,724,638,569,635,543,629,6773,6922,7217
E02006014,Highley & Ditton Priors,364,196,599,462,414,418,405,544,737,803,819,748,835,646,674,8104,8300,8664
E02006015,Whitchurch,494,203,695,620,611,596,593,641,814,801,721,616,644,537,717,8606,8809,9303
E02006016,"Woore, Prees & Tilstock",302,177,529,400,446,447,397,487,674,773,668,606,654,485,503,7069,7246,7548
E02006017,Ellesmere,419,251,562,353,429,402,421,455,642,693,631,587,572,420,569,6736,6987,7406
E02006018,Market Drayton,578,276,881,716,698,733,715,757,896,882,747,707,780,693,769,9974,10250,10828
E02006019,Wem,291,148,488,332,339,348,319,372,454,435,437,378,420,346,529,5197,5345,5636
E02006020,Hinstock & Hodnet,306,143,591,534,617,545,449,473,599,658,536,460,371,294,347,6474,6617,6923
E02006021,"Baschurch, Cockshutt & Harmer Hill",439,211,607,378,443,458,501,533,790,880,732,636,579,443,443,7423,7634,8073
E02006022,Shawbury & Weston,248,128,661,562,539,482,442,392,504,541,434,415,360,293,350,5975,6103,6351
E02006023,"Gobowen, St Martin's & Weston Rhyn",503,284,684,527,590,550,536,595,767,795,728,670,690,485,633,8250,8534,9037
E02006024,Oswestry East,405,219,697,607,711,662,630,642,720,739,616,576,565,410,560,8135,8354,8759
E02006025,Oswestry West,501,252,712,653,588,620,567,673,834,728,667,543,563,531,729,8408,8660,9161
E02006026,"Ruyton-XI-Towns, West Felton & Whittington",397,185,515,378,392,367,345,521,616,644,610,530,556,422,407,6303,6488,6885
E02006027,Trefonen & Pant,225,123,326,248,269,251,251,354,453,550,431,422,397,324,452,4728,4851,5076
E02006028,Bomere Heath & Montford Bridge,440,232,692,454,475,504,490,583,787,799,724,624,642,538,686,7998,8230,8670
E02006029,Shrewsbury Harlescott Grange,421,212,686,551,651,554,502,483,559,566,499,397,358,264,383,6453,6665,7086
E02006030,Shrewsbury Harlescott & Sundorne,386,193,614,619,734,619,523,543,563,540,485,390,354,258,351,6593,6786,7172
E02006031,Shrewsbury Greenfields,250,151,482,596,718,583,509,543,562,605,535,431,357,293,418,6632,6783,7033
E02006032,Shrewsbury Monkmoor,429,215,695,518,620,609,568,545,671,670,559,466,436,395,394,7146,7361,7790
E02006033,Shrewsbury Town,256,141,645,666,731,561,518,565,575,622,628,521,496,437,683,7648,7789,8045
E02006034,Shrewsbury Copthorne & Bowbrook,532,242,704,610,744,733,694,739,814,769,713,609,632,444,562,8767,9009,9541
E02006035,Shrewsbury London Road,220,133,327,279,328,346,300,358,406,432,414,397,533,394,570,5084,5217,5437
E02006036,Shrewsbury Sutton & Coleham,251,113,452,399,531,464,435,402,508,528,492,383,436,333,440,5803,5916,6167
E02006037,Shrewsbury Meole & Kingsland,772,519,945,493,585,545,558,659,795,728,686,611,597,440,669,8311,8830,9602
E02006038,Bayston Hill & Atcham,342,171,509,430,538,543,505,482,615,625,582,570,570,497,531,6997,7168,7510
E02006039,"Hanwood, Pontesbury & Minsterley",396,176,501,429,471,424,415,487,610,678,639,571,618,524,610,6977,7153,7549
E02006040,"Cressage, Dorrington & Pulverbatch",486,438,628,321,331,353,383,482,629,732,659,503,556,450,458,6485,6923,7409
E02006041,"Bishop's Castle, Brockton & Chirbury",243,124,356,256,259,261,276,304,421,591,548,484,494,344,401,4995,5119,5362
E02006042,Church Stretton,214,112,321,189,228,196,235,294,422,489,521,511,586,488,761,5241,5353,5567
E02006043,Craven Arms & Broadstone,258,98,409,344,376,331,312,380,480,657,583,531,504,423,463,5793,5891,6149
E02006044,Clun & Bucknell,246,150,418,234,233,207,228,317,485,577,586,576,638,465,483,5447,5597,5843
E02006045,Ludlow Town,367,208,721,534,598,530,514,573,714,774,791,752,838,725,1130,9194,9402,9769
E02006046,"Cleobury Mortimer, Burford & Ashford Carbonell",392,180,598,394,437,439,405,531,679,836,742,697,699,632,650,7739,7919,8311
E02006118,Rugeley North & Etchinghill,293,176,501,378,416,376,403,484,572,622,523,488,555,480,478,6276,6452,6745
E02006119,Rugeley Town,375,190,667,580,596,577,485,519,662,658,496,387,432,306,460,6825,7015,7390
E02006120,Rugeley South & Brereton,487,227,661,630,739,614,549,574,718,688,553,498,467,392,458,7541,7768,8255
E02006121,Hednesford Pye Green,256,112,392,418,490,389,331,370,482,446,387,342,317,217,227,4808,4920,5176
E02006122,Hednesford Central,340,143,559,577,637,571,509,527,606,578,450,379,350,260,294,6297,6440,6780
E02006123,Wimblebury & Cannock Wood,292,150,470,402,452,393,424,463,564,549,430,374,326,238,291,5376,5526,5818
E02006124,Cannock North,401,167,557,494,548,554,447,444,530,564,448,388,343,255,310,5882,6049,6450
E02006125,Cannock North East,326,135,571,523,519,503,411,446,579,552,485,396,427,365,339,6116,6251,6577
E02006126,Hednesford South & Heath Hayes,381,191,540,525,574,484,477,541,718,624,499,465,465,331,385,6628,6819,7200
E02006127,Hawks Green,381,190,536,452,463,549,480,534,663,595,487,379,246,137,167,5688,5878,6259
E02006128,Cannock West & Mill Green,319,130,572,439,464,458,454,559,644,658,557,497,688,509,701,7200,7330,7649
E02006129,Cannock South,362,194,649,608,697,617,483,494,580,580,460,387,335,318,380,6588,6782,7144
E02006130,Norton Canes,384,175,566,577,670,567,454,473,627,668,496,463,422,339,379,6701,6876,7260
E02006131,"Mayfield, Rocester & Bramshall",337,179,521,443,402,372,413,502,692,655,618,529,545,426,498,6616,6795,7132
E02006132,Uttoxeter Heath,368,187,536,510,582,518,435,442,450,520,465,337,343,285,304,5727,5914,6282
E02006133,Uttoxeter Town,311,180,615,528,466,370,433,468,621,590,516,417,374,262,384,6044,6224,6535
E02006134,Rolleston-on-Dove & Tutbury,494,222,607,462,559,626,666,758,847,837,754,649,634,550,712,8661,8883,9377
E02006135,Burton Stretton,379,175,473,403,403,418,402,478,664,644,661,504,518,404,503,6475,6650,7029
E02006136,"Abbots Bromley, Yoxall & Marchington",357,195,664,588,606,554,555,647,814,808,689,566,616,565,597,8269,8464,8821
E02006137,Burton Horninglow,526,247,659,627,751,721,625,581,630,645,516,395,399,314,449,7312,7559,8085
E02006138,Burton Eton Park,468,223,683,767,888,779,614,538,537,432,384,250,203,139,155,6369,6592,7060
E02006139,Burton Shobnall,516,211,712,810,926,865,712,566,488,452,366,333,271,159,256,6916,7127,7643
E02006140,Burton Winshill,446,208,664,516,584,572,571,520,587,608,534,436,447,367,460,6866,7074,7520
E02006141,Burton Central,701,300,1113,1321,1677,1477,1197,823,800,649,540,390,300,222,362,10871,11171,11872
E02006142,Burton Brizlincote,209,111,368,278,314,306,298,322,430,503,376,364,360,259,310,4488,4599,4808
E02006143,Branston,461,201,670,637,696,659,584,629,711,670,538,421,383,286,336,7220,7421,7882
E02006144,Burton Stapenhill,396,202,579,596,697,657,542,500,611,583,515,446,396,306,416,6844,7046,7442
E02006145,Barton-under-Needwood,324,157,346,221,228,309,378,464,521,507,425,388,437,341,390,4955,5112,5436
E02006146,Armitage & Colton,347,164,519,499,607,533,485,545,660,657,600,521,540,429,398,6993,7157,7504
E02006147,"Alrewas, Fradley & King's Bromley",401,202,595,516,526,449,486,607,685,718,570,503,525,413,485,7078,7280,7681
E02006148,Burntwood North East & Longdon,316,170,476,325,289,352,394,509,616,656,549,501,560,522,430,6179,6349,6665
E02006149,Lichfield Central,552,267,762,671,723,716,694,774,789,715,605,542,501,484,797,8773,9040,9592
E02006150,Lichfield East,463,235,641,601,708,671,728,751,810,862,881,832,934,693,865,9977,10212,10675
E02006151,Burntwood West,427,207,660,655,711,595,581,650,737,696,588,527,554,495,477,7926,8133,8560
E02006152,Lichfield West & South,497,224,656,590,616,684,752,787,823,744,591,521,638,529,601,8532,8756,9253
E02006153,"Whittington, Hopwas & Clifton Campville",411,239,910,1003,1098,1088,1035,899,969,759,578,509,493,417,473,10231,10470,10881
E02006154,Burntwood Chase Terrace & Hammerwich,384,176,593,455,497,515,508,541,806,720,606,632,823,812,740,8248,8424,8808
E02006155,Burntwood Chasetown,311,133,432,364,422,395,377,342,438,418,316,260,262,231,246,4503,4636,4947
E02006156,"Shenstone, Stonnall & Little Aston",307,160,522,358,387,385,450,502,678,710,562,516,589,539,735,6933,7093,7400
E02006157,"Fazeley, Mile Oak & Drayton Basset",286,155,967,514,460,404,375,421,528,531,412,424,405,311,375,6127,6282,6568
E02006158,Kidsgrove East,332,171,567,461,471,408,457,554,700,732,648,530,581,467,426,7002,7173,7505
E02006159,Kidsgrove Central,282,132,402,353,440,367,329,336,402,395,382,337,343,267,330,4683,4815,5097
E02006160,Kidsgrove West,368,174,632,574,637,587,507,500,600,606,536,531,565,390,436,7101,7275,7643
E02006161,Talke & Crackley,319,155,496,335,384,437,348,479,525,611,559,391,395,324,392,5676,5831,6150
E02006162,Audley & Bignall End,352,158,598,477,526,531,517,583,648,686,618,541,598,419,492,7234,7392,7744
E02006163,Bradwell,440,210,651,529,574,613,514,525,602,562,463,393,369,296,405,6496,6706,7146
E02006164,Chesterton & Knutton,380,173,624,531,601,582,507,467,505,463,447,385,313,230,344,5999,6172,6552
E02006165,Porthill,312,135,509,522,586,562,562,527,564,517,423,363,409,288,437,6269,6404,6716
E02006166,May Bank,295,152,507,433,431,474,446,485,575,563,496,445,438,330,450,6073,6225,6520
E02006167,Newcastle West & Cross Heath,484,223,1128,747,803,723,658,589,683,562,557,424,396,308,369,7947,8170,8654
E02006168,Newcastle Town,248,168,1295,713,647,586,528,493,515,514,498,379,357,277,601,7403,7571,7819
E02006169,Silverdale & Keele,303,172,3445,641,453,441,382,365,419,397,346,300,310,232,257,7988,8160,8463
E02006170,Madeley & Betley,195,116,349,268,281,275,282,341,423,431,378,341,408,292,418,4487,4603,4798
E02006171,Clayton & Langdale,435,238,737,494,617,572,551,550,647,633,562,490,530,397,630,7410,7648,8083
E02006172,Westlands & Seabridge,447,212,632,455,485,509,619,605,754,792,741,661,683,562,786,8284,8496,8943
E02006173,Loggerheads & Baldwins Gate,288,162,510,372,335,357,332,450,628,687,602,568,620,414,494,6369,6531,6819
E02006174,Penkridge & Acton Trussell,428,242,730,525,582,575,600,739,813,818,742,702,825,661,692,9004,9246,9674
E02006175,Huntington,348,143,528,440,487,461,416,413,580,587,476,316,318,263,259,5544,5687,6035
E02006176,Brewood & Wheaton Aston,352,144,515,347,371,361,443,455,627,678,604,511,582,486,546,6526,6670,7022
E02006177,Cheslyn Hay,380,197,622,568,601,600,500,639,722,748,650,650,679,593,606,8178,8375,8755
E02006178,Great Wyrley,292,155,593,477,450,465,394,427,629,640,544,435,518,436,428,6436,6591,6883
E02006179,"Featherstone West, Coven & Shareshill",259,162,1371,971,1024,816,752,626,698,731,626,457,455,440,447,9414,9576,9835
E02006180,Featherstone East & Essington,314,162,485,403,490,411,379,431,516,558,502,397,350,321,539,5782,5944,6258
E02006181,Bilbrook,252,114,332,318,352,337,312,365,389,402,374,321,367,279,442,4590,4704,4956
E02006182,Codsall,323,163,449,332,354,411,406,459,531,563,498,400,486,470,611,5970,6133,6456
E02006183,Perton West & Pattingham,302,144,463,392,467,433,394,390,540,642,636,601,498,336,462,6254,6398,6700
E02006184,Perton East,201,113,320,320,357,379,313,298,338,346,377,397,343,198,210,4196,4309,4510
E02006185,Wombourne Inner,324,158,497,453,422,385,390,430,512,592,545,433,454,382,578,6073,6231,6555
E02006186,"Wombourne Outer, Swindon & Seisdon",479,256,818,579,629,704,632,735,995,1111,991,886,818,683,1068,10649,10905,11384
E02006187,Kinver,277,147,468,300,286,337,340,464,600,597,599,497,608,543,662,6301,6448,6725
E02006188,Fulford & Meir Heath,287,116,386,269,291,300,320,380,477,470,428,407,428,393,497,5046,5162,5449
E02006189,"Barlaston, Tittensor & Swynnerton",302,140,379,288,301,356,402,393,549,625,571,517,562,439,616,5998,6138,6440
E02006190,Stone Town,564,245,696,659,770,685,658,767,904,830,669,541,633,511,747,9070,9315,9879
E02006191,Little Stoke & Milwich,336,155,503,338,423,429,470,499,642,685,591,606,607,472,427,6692,6847,7183
E02006192,Eccleshall & Yarnfield,377,164,511,474,545,575,567,637,736,769,725,624,598,506,533,7800,7964,8341
E02006193,Stafford Common & Great Bridgeford,312,141,488,466,585,569,494,477,624,474,476,407,439,400,481,6380,6521,6833
E02006194,Doxey & Holmcroft,475,189,581,622,636,654,542,522,614,584,465,348,401,309,505,6783,6972,7447
E02006195,Weston & Haywood,350,177,498,346,448,475,444,549,718,704,726,658,732,580,602,7480,7657,8007
E02006196,Stafford North East,319,131,533,638,824,767,674,519,534,470,394,309,232,209,209,6312,6443,6762
E02006197,Central Stafford,367,154,732,868,1047,964,779,642,669,566,459,345,305,266,405,8047,8201,8568
E02006198,Littleworth & Hopton,426,209,871,773,878,773,735,611,690,680,605,503,497,369,511,8496,8705,9131
E02006199,Rowley & Derrington,345,168,562,465,504,480,477,564,699,792,594,558,561,438,612,7306,7474,7819
E02006200,Highfields & Burton Manor,430,204,624,578,617,610,474,494,550,557,475,362,369,296,354,6360,6564,6994
E02006201,Weeping Cross & Brocton,629,322,706,468,594,689,814,818,883,913,806,718,922,785,957,10073,10395,11024
E02006202,Gnosall & Haughton,379,173,625,599,628,593,558,674,815,861,791,683,726,575,586,8714,8887,9266
E02006203,Mosspit & Silkmore Lane,406,190,561,487,529,580,504,509,591,579,466,414,417,306,340,6283,6473,6879
E02006204,Leek East & Upper Hulme,399,171,533,425,466,474,411,507,591,555,514,452,526,349,467,6270,6441,6840
E02006205,Biddulph Moor & Rudyard,253,128,421,261,298,328,363,490,646,623,584,584,678,505,514,6295,6423,6676
E02006206,Biddulph Central,458,204,660,526,580,483,457,595,685,620,488,376,336,215,331,6352,6556,7014
E02006207,Biddulph North & Brownlees,259,109,322,308,309,322,319,355,441,518,501,483,603,513,543,5537,5646,5905
E02006208,Leek Town,327,179,546,533,567,538,529,514,676,605,524,455,454,305,445,6691,6870,7197
E02006209,Leek South & Cheddleton,454,271,694,482,566,590,546,719,917,837,765,745,786,620,785,9052,9323,9777
E02006210,"Ipstones, Warslow & Hamps Valley",204,95,330,235,237,252,246,339,423,545,531,443,409,311,330,4631,4726,4930
E02006211,Endon & Brown Edge,284,134,404,308,334,320,328,397,553,545,446,408,468,415,617,5543,5677,5961
E02006212,Werrington & Wetley Rocks,318,246,521,365,438,423,431,431,615,600,576,564,588,483,635,6670,6916,7234
E02006213,"Cheadle North, Alton & Kingsley",315,157,432,359,348,333,375,432,585,613,510,407,452,369,383,5598,5755,6070
E02006214,Cheadle Town,252,140,438,368,359,371,321,377,467,439,429,379,423,350,389,5110,5250,5502
E02006215,"Blythe Bridge, Forsbrook & Caverswall",308,150,499,434,436,411,407,477,633,686,586,536,598,470,567,6740,6890,7198
E02006216,Cheadle South & Upper Tean,386,187,519,413,439,466,468,490,681,673,583,580,654,472,526,6964,7151,7537
E02006217,Coton Farm & Perry Crofts,457,251,759,638,688,661,624,656,725,700,613,620,631,533,691,8539,8790,9247
E02006218,Central Tamworth,341,133,704,703,803,659,559,574,714,609,483,421,447,390,504,7570,7703,8044
E02006219,Amington,405,208,689,567,642,570,522,555,652,599,478,490,453,323,250,6790,6998,7403
E02006220,Bolehall,371,139,524,444,549,482,445,460,591,559,463,415,437,398,480,6247,6386,6757
E02006221,Kettlebrook,272,145,484,384,456,421,419,449,528,483,387,317,290,185,161,4964,5109,5381
E02006222,Belgrave,357,183,534,456,561,550,466,471,484,421,395,386,413,283,280,5700,5883,6240
E02006223,Glascote Heath,467,222,602,512,622,543,549,471,451,351,310,307,323,193,145,5379,5601,6068
E02006224,Wilnecote East,343,172,552,483,551,545,454,499,627,557,551,492,373,207,162,6053,6225,6568
E02006225,Dosthill & Two Gates,343,183,475,401,495,521,417,498,613,547,539,483,480,344,379,6192,6375,6718
E02006226,Wilnecote West & Hockley,543,221,741,686,790,788,685,652,704,644,591,470,438,274,294,7757,7978,8521
E02006468,"Polesworth, Warton & Austrey",493,257,787,639,749,691,662,726,872,890,709,661,665,526,612,9189,9446,9939
E02006469,"Dordon, Hurley & Wood End",439,222,633,533,672,648,503,561,646,663,642,469,444,355,396,7165,7387,7826
E02006470,Atherstone,529,242,861,778,914,823,705,762,946,914,752,661,708,552,655,10031,10273,10802
E02006471,Kingsbury & Curdworth,284,149,486,404,413,419,371,418,609,583,561,489,551,390,369,6063,6212,6496
E02006472,Hartshill & Ansley,451,230,705,586,709,653,559,671,802,781,682,505,565,438,467,8123,8353,8804
E02006473,Coleshill & Water Orton,421,223,696,669,710,639,617,683,843,875,742,577,648,509,699,8907,9130,9551
E02006474,New Arley & Fillongley,265,122,403,364,374,352,361,396,532,596,480,400,414,298,382,5352,5474,5739
E02006475,Weddington & St Nicholas Park,477,212,593,594,690,676,636,614,609,630,585,484,527,382,541,7561,7773,8250
E02006476,Camp Hill,529,228,733,758,903,817,677,569,589,560,508,383,327,244,282,7350,7578,8107
E02006477,Horeston Grange,422,208,670,509,614,602,557,579,658,671,562,441,496,369,429,7157,7365,7787
E02006478,Galley Common & Whittleford,438,197,688,587,734,613,569,547,684,686,518,455,374,238,196,6889,7086,7524
E02006479,Nuneaton Town Centre,383,204,801,837,1071,901,777,688,650,609,489,433,362,299,327,8244,8448,8831
E02006480,Tomkinson Road,354,177,570,548,606,589,480,477,517,531,484,384,367,245,254,6052,6229,6583
E02006481,Stockingford,408,162,566,486,574,567,467,487,498,451,392,343,371,323,277,5802,5964,6372
E02006482,Bermuda & Heath End,345,170,533,488,585,494,490,462,577,470,410,363,388,280,275,5815,5985,6330
E02006483,Caldwell & Chilvers Coton,445,181,622,609,652,614,527,514,592,529,399,347,386,266,411,6468,6649,7094
E02006484,Attleborough,354,158,588,574,543,563,509,526,624,624,456,388,330,286,381,6392,6550,6904
E02006485,Whitestone,260,123,431,335,382,374,332,407,510,593,558,498,538,414,462,5834,5957,6217
E02006486,Bedworth Woodlands,301,141,545,455,474,450,385,451,557,629,511,420,421,337,416,6051,6192,6493
E02006487,Bedworth Town,305,157,549,455,501,454,442,450,518,450,431,391,437,367,404,5849,6006,6311
E02006488,Bulkington,216,97,351,313,336,307,338,349,445,479,465,432,519,486,648,5468,5565,5781
E02006489,Bedworth Coalpit Field & Exhall,451,199,613,580,657,658,609,602,618,569,412,385,371,291,255,6620,6819,7270
E02006490,Bedworth Heath,418,198,570,407,568,559,546,503,608,546,495,401,420,294,404,6321,6519,6937
E02006806,Ash Green & Keresley End,475,234,646,615,685,705,574,581,644,616,520,461,406,349,454,7256,7490,7965
E02006492,"Brinklow, Wolvey & Clifton",651,295,1124,1147,1373,1396,1163,1047,1198,1130,873,705,651,531,656,12994,13289,13940
E02006493,Brownsover,520,251,789,850,1054,1058,932,743,783,770,597,482,401,238,220,8917,9168,9688
E02006494,Town North & Newbold on Avon,338,157,629,686,763,721,626,570,564,517,380,328,287,240,368,6679,6836,7174
E02006495,"Wolston, Binley Woods & Ryton",339,177,539,455,488,462,462,553,567,626,523,463,508,468,488,6602,6779,7118
E02006496,Town East,339,133,615,805,882,837,706,555,550,499,396,228,208,131,176,6588,6721,7060
E02006497,New Bilton,406,185,647,762,931,884,676,632,605,492,448,287,266,209,261,7100,7285,7691
E02006498,Cawston & Long Lawford,914,408,996,784,1014,1108,1053,1096,1083,922,703,524,618,417,421,10739,11147,12061
E02006499,Eastlands,377,164,429,339,452,459,530,511,526,516,383,299,301,277,368,5390,5554,5931
E02006500,Town South & School,589,432,447,368,428,399,397,374,398,402,385,318,304,299,422,4941,5373,5962
E02006501,Hillmorton,554,238,626,557,700,694,715,726,729,691,555,515,488,503,617,8116,8354,8908
E02006502,Overslade & Bilton,537,244,689,551,692,746,712,724,775,782,716,597,759,714,1045,9502,9746,10283
E02006503,"Dunchurch, Stretton-on-Dunsmore & Marton",519,221,692,571,607,614,601,648,743,820,647,554,624,574,711,8406,8627,9146
E02006504,"Earlswood, Tanworth-in-Arden & Sambourne",267,122,391,295,288,249,293,377,540,550,526,442,415,391,440,5197,5319,5586
E02006505,Henley-in-Arden & Claverdon,333,170,418,312,345,337,376,456,601,589,546,486,569,541,669,6245,6415,6748
E02006506,Studley,293,120,408,317,323,357,371,386,448,462,407,337,394,325,458,4993,5113,5406
E02006507,"Southam, Stockton & Napton",528,269,784,801,822,692,713,805,864,869,723,552,613,516,655,9409,9678,10206
E02006508,"Harbury, Long Itchington & Fenny Compton",520,240,694,596,770,685,740,813,900,960,785,679,649,600,600,9471,9711,10231
E02006509,Alcester,254,118,364,312,328,306,377,330,489,500,428,389,429,397,495,5144,5262,5516
E02006510,Wilmcote & Great Alne,321,164,510,364,373,445,432,478,536,614,565,505,569,518,604,6513,6677,6998
E02006511,Wellesbourne & Snitterfield,500,242,697,572,742,722,645,728,846,855,746,689,697,557,695,9191,9433,9933
E02006512,Stratford North,535,252,979,1028,1186,1151,1084,921,997,939,907,699,707,574,742,11914,12166,12701
E02006513,Stratford South East & Tiddington,444,219,610,412,484,533,616,687,710,692,582,480,540,444,712,7502,7721,8165
E02006514,Stratford South West,408,211,646,614,653,627,624,621,763,752,707,603,697,568,857,8732,8943,9351
E02006515,Bidford & Welford,504,262,679,597,710,664,683,755,926,1014,837,738,795,589,667,9654,9916,10420
E02006516,"Kineton, Tysoe & Warmington",419,192,619,569,656,570,589,678,854,857,794,644,642,519,572,8563,8755,9174
E02006517,Lower Quinton & Ettington,493,236,605,583,644,673,652,708,733,821,670,589,610,483,497,8268,8504,8997
E02006518,Shipston-on-Stour & Brailes,399,198,575,487,548,568,526,677,781,888,841,716,797,649,839,8892,9090,9489
E02006519,Kenilworth West,360,183,543,503,569,527,572,527,547,609,540,511,526,466,638,7078,7261,7621
E02006520,Kenilworth East,425,227,660,461,460,494,556,603,685,741,577,497,550,446,610,7340,7567,7992
E02006521,Kenilworth South,352,182,510,332,385,411,473,506,557,610,513,434,524,442,685,6382,6564,6916
E02006522,Kingswood & Leek Wootton,270,128,398,287,265,338,347,418,529,584,524,419,413,315,347,5184,5312,5582
E02006523,"Cubbington, Stoneleigh & Radford Semele",455,223,616,550,606,644,676,673,815,817,710,622,660,543,746,8678,8901,9356
E02006524,Lillington,265,121,430,433,500,459,365,363,423,382,332,279,262,203,279,4710,4831,5096
E02006525,Leamington Central & North,577,277,1667,1243,1348,1150,999,1022,996,934,672,598,657,560,871,12717,12994,13571
E02006526,Warwick North,350,154,558,621,743,695,714,576,565,585,582,572,512,403,447,7573,7727,8077
E02006527,Leamington West & Milverton,381,181,988,834,893,856,820,763,752,636,520,444,490,393,483,8872,9053,9434
E02006528,Leamington East & Sydenham,404,172,1532,1056,1296,1152,986,816,723,656,487,476,436,310,393,10319,10491,10895
E02006529,Warwick South West & Aylesford,650,299,856,953,1124,1161,1029,975,934,809,676,545,548,411,531,10552,10851,11501
E02006530,"Warwick South East, Myton & Heathcote",688,379,944,827,1118,1104,1081,988,1001,905,683,554,598,490,650,10943,11322,12010
E02006531,Leamington Brunswick,429,189,1943,883,1227,1179,854,600,583,556,496,391,270,206,264,9452,9641,10070
E02006532,"Bishops Tachbrook, Barford & Hatton Park",559,265,691,650,1021,895,853,876,823,762,648,546,514,437,430,9146,9411,9970
E02006533,Whitnash,459,245,748,705,951,896,783,778,775,689,596,468,424,345,517,8675,8920,9379
E02006696,Hagley,457,223,466,306,320,447,496,541,566,527,354,313,371,407,569,5683,5906,6363
E02006697,"Dodford, Belbroughton & Romsley",371,184,472,342,333,351,403,496,650,727,601,525,499,436,547,6382,6566,6937
E02006698,Rubery West,286,151,469,402,410,408,392,431,495,532,442,390,378,262,470,5481,5632,5918
E02006699,Hollywood & Drakes Cross,301,121,341,318,345,359,339,321,398,450,416,396,397,367,468,4915,5036,5337
E02006700,Wythall & Gay Hill,293,137,399,334,337,377,351,420,492,526,430,398,398,406,562,5430,5567,5860
E02006701,Barnt Green & Lickey Hills,313,153,458,365,428,495,522,483,576,556,507,467,404,336,442,6039,6192,6505
E02006702,Catshill,283,117,428,394,467,396,391,392,480,424,362,328,356,258,331,5007,5124,5407
E02006703,Marlbrook & Lickey End,349,163,512,396,528,544,527,532,606,648,545,491,466,375,501,6671,6834,7183
E02006704,"Alvechurch, Hopwood & Holt End",320,157,378,303,365,373,481,506,544,516,497,475,471,370,520,5799,5956,6276
E02006705,Bromsgrove Sidemoor,351,170,528,468,558,527,438,512,584,557,414,390,381,324,385,6066,6236,6587
E02006706,Bromsgrove Central & Sanders Park,493,375,645,404,382,370,354,408,516,501,508,388,420,358,671,5925,6300,6793
E02006707,Bromsgrove Stoney Hill,439,204,491,270,340,406,473,635,616,493,393,324,401,284,359,5485,5689,6128
E02006708,Bromsgrove Charford,461,218,637,565,628,575,547,545,585,549,432,354,339,240,300,6296,6514,6975
E02006709,"Stoke Heath, Finstall & Bentley",303,170,609,686,732,692,621,567,650,684,597,540,475,378,350,7581,7751,8054
E02006710,"Tenbury Wells, Mamble & Clifton",339,174,523,333,366,401,425,483,686,743,694,642,694,557,610,7157,7331,7670
E02006711,"Abberley, Holt Heath & Hallow",410,227,598,339,367,413,458,569,728,785,691,618,609,506,615,7296,7523,7933
E02006712,"Broadheath, Sinton & Alfrick",317,173,467,352,405,381,406,479,589,710,594,535,616,444,570,6548,6721,7038
E02006713,Malvern Link,230,126,371,383,396,305,368,367,509,495,463,379,439,407,637,5519,5645,5875
E02006714,"Colletts Green, Callow End & Hanley",272,106,356,246,270,288,322,369,442,495,491,407,523,384,527,5120,5226,5498
E02006715,North Malvern,441,210,590,484,497,554,593,605,680,746,632,556,547,348,440,7272,7482,7923
E02006716,Malvern Pickersleigh,372,176,546,440,456,398,398,379,459,456,417,329,322,281,342,5223,5399,5771
E02006717,Kempsey & Ryall,299,153,363,293,383,396,367,399,541,544,512,485,518,425,504,5730,5883,6182
E02006718,Barnard's Green,338,189,475,264,291,274,312,315,443,486,465,448,525,400,627,5325,5514,5852
E02006719,Malvern Wells & Priory,473,432,669,318,356,322,380,406,502,623,573,597,650,472,756,6624,7056,7529
E02006720,"Upton-upon-Severn, Welland & Eldersfield",287,182,421,301,354,307,341,422,567,675,686,568,566,444,565,6217,6399,6686
E02006721,Riverside & Church Hill North,269,121,389,352,462,463,461,359,361,414,409,465,497,334,315,5281,5402,5671
E02006722,Church Hill South,353,155,438,421,515,523,438,355,330,296,293,283,263,118,103,4376,4531,4884
E02006723,Batchley & Brockhill,550,242,664,674,781,773,691,622,660,576,454,361,325,235,315,7131,7373,7923
E02006724,Redditch Town & Abbeydale,364,188,694,693,802,769,671,556,481,421,328,283,227,144,232,6301,6489,6853
E02006725,Winyates Green,272,128,427,413,455,470,444,415,380,340,360,379,360,191,166,4800,4928,5200
E02006726,Southcrest,319,148,539,509,570,588,485,442,497,443,362,340,323,222,266,5586,5734,6053
E02006727,Arrow Valley & Ipsley,277,139,389,364,426,420,446,414,429,416,344,399,398,295,325,5065,5204,5481
E02006728,Webheath,340,154,464,433,517,438,458,489,578,581,573,523,432,346,496,6328,6482,6822
E02006729,Matchborough & Park Farm,403,166,612,510,590,592,617,481,519,450,464,470,523,298,218,6344,6510,6913
E02006730,Greenlands,429,193,583,547,628,608,493,439,431,319,289,256,254,185,157,5189,5382,5811
E02006731,Oakenshaw,216,120,345,353,384,363,358,323,409,467,430,375,349,281,246,4683,4803,5019
E02006732,Crabbs Cross,319,173,457,383,451,407,465,488,557,561,512,463,423,321,356,5844,6017,6336
E02006733,Hunt End & Feckenham,291,141,370,292,361,344,377,399,517,527,431,399,404,320,277,5018,5159,5450
E02006734,Northwick,406,187,417,365,428,552,587,632,619,586,526,513,505,445,607,6782,6969,7375
E02006735,Warndon West,296,134,466,463,499,473,376,297,352,403,331,235,173,144,220,4432,4566,4862
E02006736,Warndon East,290,160,506,501,510,459,477,473,633,585,412,260,236,179,163,5394,5554,5844
E02006737,Barbourne & Rainbow Hill,354,166,587,524,613,638,574,607,657,561,505,438,442,338,345,6829,6995,7349
E02006738,King George's Field,616,270,855,737,890,855,761,594,642,621,550,432,301,236,292,7766,8036,8652
E02006739,Henwick,162,80,859,409,325,253,265,278,338,345,290,275,282,275,404,4598,4678,4840
E02006740,Worcester Town North,195,115,879,916,862,698,551,505,553,531,384,341,319,233,302,7074,7189,7384
E02006741,Lyppard Grange,335,156,498,435,511,470,448,496,534,492,365,271,248,150,253,5171,5327,5662
E02006742,Dines Green & St Johns,445,217,1082,673,657,584,609,526,618,547,475,381,385,298,408,7243,7460,7905
E02006743,Ronkswood & Nunnery Wood,433,178,590,531,663,593,509,542,505,455,366,333,329,186,208,5810,5988,6421
E02006744,Worcester Town South,315,157,724,756,812,630,643,558,559,546,393,342,290,194,269,6716,6873,7188
E02006745,Lower Wick & Bromwich Road,400,193,687,535,537,600,584,529,629,619,526,535,573,403,629,7386,7579,7979
E02006746,Battenhall & Diglis,382,183,667,644,648,637,598,559,675,610,492,467,522,365,448,7332,7515,7897
E02006747,St Peters,272,121,404,368,354,355,359,396,492,483,407,282,311,236,271,4718,4839,5111
E02006748,Hartlebury & Wychbold,404,193,550,545,612,564,523,565,692,720,602,501,520,392,510,7296,7489,7893
E02006749,Droitwich Spa West & North,342,165,455,363,429,414,378,354,387,363,276,290,290,195,183,4377,4542,4884
E02006750,Droitwich Spa East,210,86,348,280,351,330,317,302,379,384,387,344,395,328,572,4717,4803,5013
E02006751,Droitwich Spa Central,311,123,426,303,350,357,373,389,456,442,389,326,400,327,442,4980,5103,5414
E02006752,Droitwich Spa South,355,196,582,512,559,517,531,490,651,646,530,537,522,388,462,6927,7123,7478
E02006753,Fernhill Heath & Ombersley,349,184,480,380,458,434,434,485,593,638,526,500,509,375,487,6299,6483,6832
E02006754,Crowle & Tibberton,249,124,339,263,223,271,321,386,519,510,479,419,451,356,326,4863,4987,5236
E02006755,Inkberrow & Flyford Flavell,214,126,371,247,264,241,312,347,484,575,514,453,459,413,470,5150,5276,5490
E02006756,Drakes Broughton & Norton,318,153,482,368,435,434,394,481,529,563,405,357,364,261,280,5353,5506,5824
E02006757,"Wick, Elmley Castle & Fladbury",272,159,488,330,327,348,351,435,581,692,671,544,612,481,607,6467,6626,6898
E02006758,Honeybourne & Littleton,260,138,418,389,433,396,397,428,531,608,505,417,433,315,292,5562,5700,5960
E02006759,Pershore,362,177,500,486,485,440,440,467,621,584,560,566,632,572,751,7104,7281,7643
E02006760,"Harvington, Offenham & Badsey",402,176,560,443,565,508,546,611,687,761,676,666,635,540,664,7862,8038,8440
E02006761,Evesham Central,270,124,462,632,695,673,551,478,447,431,365,337,282,205,323,5881,6005,6275
E02006762,Evesham North & Hampton,315,160,483,496,549,490,480,485,528,550,445,361,420,348,437,6072,6232,6547
E02006763,Evesham East,435,198,563,520,670,706,559,557,624,585,525,465,504,313,495,7086,7284,7719
E02006764,Evesham South,272,132,394,415,498,509,423,434,449,406,334,314,284,195,232,4887,5019,5291
E02006765,"Broadway, Wickhamford & Sedgeberrow",216,88,344,297,313,277,288,312,501,542,549,537,569,478,673,5680,5768,5984
E02006766,"Bredon, Ashton & Eckington",350,197,457,317,345,337,362,505,654,737,703,648,723,528,578,6894,7091,7441
E02006767,"Wolverley, Cookley & Blakedown",420,196,588,405,440,444,500,585,791,850,697,654,735,624,711,8024,8220,8640
E02006768,Franche,309,116,454,395,451,426,400,447,514,508,414,378,506,480,451,5824,5940,6249
E02006769,Greenhill,296,148,464,420,479,439,418,484,586,541,427,401,427,354,470,5910,6058,6354
E02006770,Kidderminster Town,388,187,699,699,776,670,605,550,616,529,430,298,305,256,250,6683,6870,7258
E02006771,Bewdley East & Upper Arley,280,157,392,277,330,306,359,412,573,595,546,550,594,481,484,5899,6056,6336
E02006772,Habberley,277,148,468,368,448,397,355,468,549,482,418,383,462,384,511,5693,5841,6118
E02006773,Comberton,355,187,537,477,528,487,504,536,561,552,504,519,635,481,601,6922,7109,7464
E02006774,Foley Park,318,132,546,509,560,509,504,556,613,565,437,389,418,296,306,6208,6340,6658
E02006775,Birchen Coppice,372,181,562,432,487,513,387,397,422,414,324,290,291,218,224,4961,5142,5514
E02006776,Spennells & Hoobrook,250,115,409,345,411,350,372,393,499,496,451,425,507,331,328,5317,5432,5682
E02006777,"Bewdley West, Ribbesford & Far Forest",281,131,413,278,300,326,334,452,601,679,633,632,685,565,614,6512,6643,6924
E02006778,Stourport Lickhill & Burlish,332,143,501,398,425,423,379,452,546,623,398,424,528,432,591,6120,6263,6595
E02006779,Stourport Mitton & Wilden,343,176,538,421,421,448,433,525,663,655,579,515,612,451,512,6773,6949,7292
E02006780,Stourport Areley Kings,225,104,365,283,332,325,302,328,422,432,405,440,505,453,469,5061,5165,5390
E02001827,Hill Hook,342,155,438,314,313,431,465,430,451,459,382,394,375,315,509,5276,5431,5773
E02001828,Four Oaks,396,168,455,299,393,459,484,485,586,526,446,359,425,424,657,5998,6166,6562
E02001829,Little Sutton & Roughley,556,251,621,400,486,685,729,742,715,650,477,455,479,430,545,7414,7665,8221
E02001830,Sutton Coldfield North & Park,491,222,675,497,518,519,629,654,769,800,681,572,651,558,805,8328,8550,9041
E02001831,Reddicap Heath,611,299,768,711,781,871,748,717,770,765,673,489,472,357,513,8635,8934,9545
E02001832,Rectory Park & New Hall Valley,345,180,550,450,446,493,503,569,626,667,597,470,491,394,496,6752,6932,7277
E02001833,Kingstanding North,311,139,463,362,431,409,391,408,493,456,396,335,303,254,326,5027,5166,5477
E02001834,Old Oscott,400,176,538,465,545,486,385,383,487,419,326,225,233,184,220,4896,5072,5472
E02001835,Sutton Coldfield South & Central,425,181,498,510,573,631,631,656,638,625,541,432,437,325,573,7070,7251,7676
E02001836,New Oscott,427,205,526,482,601,637,614,607,656,731,660,568,512,448,606,7648,7853,8280
E02001837,Kingstanding South East,791,377,1041,808,938,872,784,725,766,801,563,421,342,236,308,8605,8982,9773
E02001838,Walmley,321,188,482,422,492,496,441,537,575,590,598,589,487,359,462,6530,6718,7039
E02001839,Queslett,326,139,463,491,517,482,380,409,481,497,440,305,292,232,375,5364,5503,5829
E02001840,Perry Common - College Road,696,320,1046,714,776,796,712,636,650,612,553,407,309,235,334,7780,8100,8796
E02001841,Wylde Green,321,136,413,298,296,378,444,429,457,487,447,426,513,387,456,5431,5567,5888
E02001842,Perry Beeches West,432,203,643,539,670,669,560,492,596,588,487,313,323,287,369,6536,6739,7171
E02001843,Kingstanding South West,300,179,528,481,526,509,422,409,454,511,374,312,303,260,351,5440,5619,5919
E02001844,Chester Road,366,169,583,585,733,744,622,689,641,797,695,559,551,463,803,8465,8634,9000
E02001845,Perry Beeches East,367,173,506,525,551,516,460,409,494,476,350,269,245,229,185,5215,5388,5755
E02001846,Short Heath,456,230,744,619,696,722,608,507,597,563,510,331,258,243,239,6637,6867,7323
E02001847,Minworth,263,114,340,294,378,398,377,359,398,433,415,370,377,275,334,4748,4862,5125
E02001848,Upper Witton,505,211,679,518,648,599,544,477,484,452,363,225,232,168,310,5699,5910,6415
E02001849,Erdington Town,508,228,718,806,975,871,672,600,550,533,420,316,226,172,218,7077,7305,7813
E02001850,Perry Barr & South Hamstead,570,257,902,660,778,761,719,588,640,563,483,338,315,262,362,7371,7628,8198
E02001851,Pype Hayes Park,499,232,698,616,733,703,655,589,745,686,567,451,404,279,375,7501,7733,8232
E02001852,Stockland Green - Marsh Hill,427,181,693,640,714,741,603,511,495,530,456,299,269,183,265,6399,6580,7007
E02001854,Birches Green,440,193,597,619,725,717,593,510,622,612,505,362,318,262,360,6802,6995,7435
E02001855,Castle Vale,644,302,1041,793,811,736,615,621,802,764,563,435,355,302,507,8345,8647,9291
E02001856,Brookvale,596,282,894,932,1102,1049,850,705,661,605,439,341,223,158,224,8183,8465,9061
E02001857,Gravelly Hill & South Erdington,782,431,1433,1402,1452,1364,1206,1063,1042,954,754,467,384,243,377,12141,12572,13354
E02001858,Handsworth East,508,258,1044,849,901,872,798,686,678,649,497,380,251,159,276,8040,8298,8806
E02001859,Birchfield East,848,409,1462,1245,1541,1409,1166,823,763,570,420,356,228,167,309,10459,10868,11716
E02001860,Handsworth West,797,371,1214,926,1016,1038,1050,868,706,619,444,320,194,154,258,8807,9178,9975
E02001861,Birchfield West,863,436,1418,1053,1173,1161,1090,933,762,634,493,358,211,170,284,9740,10176,11039
E02001862,Middlemore,812,385,1420,1083,1135,1150,1078,1005,826,747,581,410,284,162,342,10223,10608,11420
E02001863,Aston Park,722,354,1165,836,867,836,779,731,591,393,305,281,175,113,232,7304,7658,8380
E02001864,Bromford,488,240,617,420,473,469,427,367,346,309,262,158,154,104,142,4248,4488,4976
E02001865,Handsworth South,886,455,1676,1301,1384,1459,1250,1083,937,808,573,426,261,184,324,11666,12121,13007
E02001866,Lozells West,734,331,1200,962,1016,965,977,847,742,535,440,295,195,113,240,8527,8858,9592
E02001867,Lozells East,787,387,1128,783,805,859,749,704,527,459,339,240,160,130,213,7096,7483,8270
E02001868,Hodge Hill,762,367,1290,754,777,803,723,653,625,456,364,290,264,201,355,7555,7922,8684
E02001869,Nechells,622,268,762,569,573,629,586,490,410,359,293,207,129,99,132,5238,5506,6128
E02001870,Ward End & Bromford West,1185,572,1712,1053,1148,1197,1147,883,824,596,468,369,288,199,342,10226,10798,11983
E02001871,Buckland End,511,203,712,621,736,669,597,492,569,543,482,381,360,288,358,6808,7011,7522
E02001872,Shard End & Kingfisher,441,222,643,567,668,590,462,447,553,493,402,326,314,212,264,5941,6163,6604
E02001873,Winson Green & Gib Heath,934,471,1532,1186,1338,1307,1223,1029,870,673,542,372,234,173,242,10721,11192,12126
E02001874,Washwood Heath,944,433,1449,969,961,995,914,741,599,470,380,282,178,133,194,8265,8698,9642
E02001875,Hockley & Jewellery Quarter,673,314,1078,1019,976,909,797,657,574,425,318,174,125,98,113,7263,7577,8250
E02001876,North Central & Dartmouth Circus,568,281,4150,2558,1618,985,771,613,484,457,294,184,137,89,189,12529,12810,13378
E02001877,Saltley East,1145,533,1809,1164,1247,1166,1129,891,716,524,370,400,221,140,287,10064,10597,11742
E02001878,Saltley West,811,372,1335,947,961,891,828,688,642,409,377,278,162,105,229,7852,8224,9035
E02001879,Summerfield,682,362,1499,1367,1506,1332,1152,912,776,614,462,302,177,175,332,10606,10968,11650
E02001880,Glebe Farm,773,398,1036,796,869,852,671,657,619,575,443,334,250,172,189,7463,7861,8634
E02001881,Belchers Lane & Eastfield Road,1043,493,1459,902,883,1021,910,785,656,453,377,286,206,135,222,8295,8788,9831
E02001882,Stechford,598,267,891,689,757,740,655,568,512,467,431,344,272,250,316,6892,7159,7757
E02001883,Kitts Green,471,242,698,658,730,642,528,494,619,570,464,310,328,219,279,6539,6781,7252
E02001884,Bordesley Green North,1109,532,1577,935,915,980,908,746,663,404,310,222,143,90,165,8058,8590,9699
E02001886,Rotton Park,583,316,1201,1162,1176,1201,1144,884,771,630,478,376,336,207,320,9886,10202,10785
E02001888,Kent's Moat,522,248,672,531,584,569,506,413,484,401,357,271,252,212,283,5535,5783,6305
E02001889,Little Bromwich,867,444,1359,816,872,861,742,725,601,424,347,265,154,120,222,7508,7952,8819
E02001890,Edgbaston North,428,220,1407,1333,1398,1300,1049,775,722,624,488,413,359,295,418,10581,10801,11229
E02001892,Yardley Fields,993,474,1312,903,1017,1051,965,817,704,563,486,280,247,168,230,8743,9217,10210
E02001893,Yardley,564,275,859,632,690,642,621,566,623,634,475,404,351,273,412,7182,7457,8021
E02001895,Sheldon North,533,272,873,674,743,641,636,543,622,580,477,361,356,276,409,7191,7463,7996
E02001896,Small Heath Park,837,431,1419,971,1066,1092,989,831,705,509,368,329,190,121,301,8891,9322,10159
E02001897,Sparkbrook North,682,318,1131,746,921,943,768,676,641,503,426,251,178,135,245,7564,7882,8564
E02001898,Lyndon Green,286,157,507,440,501,479,372,369,506,515,437,321,315,286,349,5397,5554,5840
E02001899,Harborne West,413,208,519,502,681,715,741,695,592,538,470,477,491,411,669,7501,7709,8122
E02001900,Five Ways South & Calthorpe Park,393,173,915,661,711,639,569,491,473,418,372,265,255,201,302,6272,6445,6838
E02001901,Harborne East,312,141,677,890,950,979,799,633,577,518,437,382,315,216,329,7702,7843,8155
E02001902,Yardley South,341,161,491,430,517,514,442,353,425,441,411,272,241,186,242,4965,5126,5467
E02001903,Sparkbrook South,673,307,1173,824,891,863,712,636,488,353,349,274,173,107,196,7039,7346,8019
E02001904,Hay Mills & Tyseley,583,252,858,619,781,847,728,621,495,443,368,266,200,134,229,6589,6841,7424
E02001905,Edgbaston South & University,402,242,5272,2092,1345,1073,995,710,481,395,346,283,275,234,393,13894,14136,14538
E02001906,Quinton Ridgacre,501,247,813,614,756,774,723,701,751,698,555,426,411,318,416,7956,8203,8704
E02001907,Sheldon South,480,237,827,763,852,799,673,661,718,775,650,476,450,406,504,8554,8791,9271
E02001908,Sparkhill North,775,369,1340,1020,977,917,910,724,642,407,350,307,170,133,228,8125,8494,9269
E02001909,Balsall Heath East,700,343,1158,796,886,843,754,627,554,379,329,246,144,114,220,7050,7393,8093
E02001910,Balsall Heath West & Kingswood Road,583,261,937,680,702,693,589,526,496,375,307,246,166,121,219,6057,6318,6901
E02001911,Quinton East,638,272,814,627,792,785,680,630,643,498,407,309,270,226,290,6971,7243,7881
E02001913,Metchley,370,141,1767,2069,1414,1033,831,600,523,392,353,311,274,224,327,10118,10259,10629
E02001914,Moor Green & Cannon Hill,454,190,749,622,661,641,554,564,476,398,345,309,242,145,225,5931,6121,6575
E02001915,Acocks Green East,630,290,998,924,1078,1142,975,825,885,834,696,501,415,324,468,10065,10355,10985
E02001916,Acocks Green West,713,336,1077,761,891,864,799,669,652,498,386,309,264,198,271,7639,7975,8688
E02001918,Moseley Village,416,170,661,882,900,821,828,716,698,643,539,435,414,207,316,8060,8230,8646
E02001919,Moseley,328,160,674,651,661,603,561,523,490,417,348,356,225,173,318,6000,6160,6488
E02001920,Woodgate Valley,471,222,663,591,600,576,553,610,574,471,393,362,386,290,227,6296,6518,6989
E02001921,California,518,222,698,623,743,720,675,596,505,513,420,341,310,239,289,6672,6894,7412
E02001922,Selly Oak,185,64,9753,2836,1277,919,794,366,207,144,115,87,69,49,97,16713,16777,16962
E02001923,Springfield & Hall Green West,832,407,1323,985,986,1050,1010,799,726,596,548,474,361,268,423,9549,9956,10788
E02001924,Hall Green East,456,207,728,532,552,561,556,462,518,477,412,333,220,160,246,5757,5964,6420
E02001925,Selly Oak Park & Lodge Hill,382,162,778,634,572,611,679,524,465,414,378,328,322,265,403,6373,6535,6917
E02001926,Stirchley North & Selly Park,339,162,1127,873,956,794,755,584,475,414,368,309,262,209,347,7473,7635,7974
E02001927,Weoley Castle,557,269,720,636,645,597,602,556,618,554,385,335,282,217,356,6503,6772,7329
E02001928,Woodgate,390,155,559,447,496,517,455,485,466,484,441,379,391,261,270,5651,5806,6196
E02001929,Fox Hollies,802,307,1030,793,902,877,791,645,724,617,448,329,261,164,257,7838,8145,8947
E02001930,Kings Heath,419,183,521,633,747,758,654,639,666,522,425,401,296,220,215,6697,6880,7299
E02001931,Wake Green East & Moseley Bog,474,269,738,579,627,665,594,542,588,567,527,452,437,316,386,7018,7287,7761
E02001932,Bartley Green & Shenley Fields,462,234,717,623,713,600,577,501,502,511,397,306,273,163,226,6109,6343,6805
E02001933,Kings Heath Park & Stirchley East,471,208,646,586,705,700,633,562,594,503,442,346,281,229,305,6532,6740,7211
E02001934,Hall Green Central,470,214,641,527,551,537,493,502,497,435,392,329,282,234,320,5740,5954,6424
E02001935,Shenley Lane,548,258,643,450,560,629,666,583,544,539,459,404,380,323,514,6694,6952,7500
E02001936,Brandwood North,321,165,458,329,419,477,502,463,480,468,407,347,339,293,386,5368,5533,5854
E02001937,Billesley Common,569,255,720,584,727,726,683,504,529,527,418,354,314,207,322,6615,6870,7439
E02001938,Bournville East & Stirchley West,344,166,571,660,863,797,705,587,632,547,437,342,283,189,258,6871,7037,7381
E02001939,Bournville West,295,120,406,409,452,421,469,388,426,440,397,361,408,318,512,5407,5527,5822
E02001941,Yardley Wood West,370,179,567,440,530,511,390,394,404,386,329,265,250,180,282,4928,5107,5477
E02001942,Cotteridge,379,168,560,449,486,580,454,451,526,492,383,315,315,253,330,5594,5762,6141
E02001943,Brandwood East,357,162,480,461,475,534,498,425,489,499,409,301,283,175,253,5282,5444,5801
E02001944,Brandwood End,420,189,636,537,635,621,603,572,637,547,416,378,354,258,278,6472,6661,7081
E02001945,Allens Cross,566,255,762,675,666,598,574,585,554,500,468,340,251,177,198,6348,6603,7169
E02001946,Northfield Victoria Common,373,199,605,527,549,549,527,514,568,573,562,424,433,292,406,6529,6728,7101
E02001947,Druids Heath,385,174,559,447,544,468,394,344,408,394,371,269,211,180,279,4868,5042,5427
E02001948,Highter's Heath & Maypole,364,144,537,520,583,512,446,444,525,566,462,331,343,244,366,5879,6023,6387
E02001949,Lifford & Walkers Heath,329,143,468,446,536,408,411,401,411,392,335,241,223,189,306,4767,4910,5239
E02001950,Longbridge North,420,192,652,572,680,645,546,540,597,639,538,451,446,353,389,7048,7240,7660
E02001951,Frankley,601,280,791,682,742,746,704,563,578,520,509,508,445,250,221,7259,7539,8140
E02001952,Turves Green,602,243,850,726,778,665,608,590,651,667,524,437,360,234,291,7381,7624,8226
E02001953,King's Norton,350,186,510,400,517,513,511,461,501,512,425,372,457,328,445,5952,6138,6488
E02001954,Hawkesley,555,245,680,566,653,617,559,478,543,456,407,343,414,225,241,6182,6427,6982
E02001955,Longbridge South,414,201,620,594,671,625,551,505,516,480,421,324,271,260,432,6270,6471,6885
E02001956,Rubery East,393,166,557,502,519,511,454,441,545,528,394,314,284,198,225,5472,5638,6031
E02001957,West Heath,344,193,609,573,636,535,484,477,572,565,498,366,368,338,382,6403,6596,6940
E02006807,Yardley Wood East,477,237,690,485,553,636,618,600,564,533,443,404,326,286,368,6506,6743,7220
E02006809,Handsworth Wood,589,292,987,821,874,934,794,709,743,709,674,589,432,242,467,8975,9267,9856
E02006895,Attwood Green & Park Central,418,165,1864,1821,1772,1249,858,530,427,366,252,172,144,98,162,9715,9880,10298
E02006896,Digbeth,131,60,1344,1460,1296,827,528,353,290,232,181,119,81,62,71,6844,6904,7035
E02006897,Five Ways North,324,163,1825,1501,1326,993,755,548,434,362,277,146,116,64,80,8427,8590,8914
E02006898,Ladywood -Summer Hill,260,118,1033,1629,1317,958,581,456,364,342,270,191,95,64,84,7384,7502,7762
E02006899,Central,52,23,1212,1899,1516,891,503,275,230,194,116,64,52,28,18,6998,7021,7073
E02006900,Bordesley,1405,711,2317,1484,1587,1621,1440,1243,1067,676,623,456,254,199,413,13380,14091,15496
E02006901,Greet & Sparkhill South,1441,676,2066,1345,1610,1705,1583,1272,1014,652,569,496,271,200,354,13137,13813,15254
E02001958,Longford,440,222,727,669,727,716,627,597,618,563,468,356,289,258,286,6901,7123,7563
E02001959,Keresley,415,202,588,509,565,578,492,527,472,519,383,304,282,229,383,5831,6033,6448
E02001961,Bell Green,514,228,812,701,739,710,704,584,657,575,472,335,260,229,260,7038,7266,7780
E02001962,Little Heath,538,215,828,698,778,793,669,541,544,390,327,246,193,114,220,6341,6556,7094
E02001963,Whitmore Park,313,166,540,394,423,418,441,378,503,423,415,345,298,217,320,5115,5281,5594
E02001964,Henley Green & Wood End,896,350,1064,906,1075,1074,906,792,685,611,518,397,259,215,257,8759,9109,10005
E02001965,Walsgrave & Woodway Park,481,190,656,580,701,658,587,572,588,607,591,498,394,311,397,7140,7330,7811
E02001966,Foleshill West,597,280,954,821,845,845,750,627,573,377,273,214,155,103,190,6727,7007,7604
E02001967,Brownshill Green,346,167,587,470,456,479,464,468,543,546,406,400,442,419,508,6188,6355,6701
E02001968,Radford East,624,257,762,699,778,827,746,627,612,477,349,311,229,175,226,6818,7075,7699
E02001969,Radford West,424,182,612,519,610,625,559,519,463,437,395,252,261,191,331,5774,5956,6380
E02001970,Wyken Croft,280,128,418,499,521,478,388,378,406,368,320,281,267,289,464,5077,5205,5485
E02001971,Coundon,320,158,520,429,486,396,427,421,514,475,382,274,280,231,280,5115,5273,5593
E02001972,Foleshill East,845,380,1605,1334,1423,1383,1191,976,843,568,476,360,240,149,241,10789,11169,12014
E02001973,Stoke Heath,565,227,868,786,885,880,788,638,635,595,458,327,293,210,255,7618,7845,8410
E02001974,Sherbourne,486,220,730,589,785,727,619,645,714,682,574,426,436,349,538,7814,8034,8520
E02001975,Ravensdale,461,202,688,625,689,633,571,570,600,581,483,335,270,228,297,6570,6772,7233
E02001976,Clifford Park,450,208,586,563,627,628,626,564,565,484,416,395,406,273,403,6536,6744,7194
E02001977,Naul's Mill & Bishopsgate Green,487,211,1686,1367,1240,1061,837,707,676,538,400,313,251,198,252,9526,9737,10224
E02001978,Barras Heath,366,192,668,584,672,578,536,455,533,458,375,286,247,193,244,5829,6021,6387
E02001979,Allesley Park,259,116,391,351,448,422,371,381,395,391,377,252,267,262,473,4781,4897,5156
E02001980,Allesley Green & Lower Eastern Green,215,118,388,294,367,299,314,356,441,444,379,340,441,405,497,4965,5083,5298
E02001981,Hillfields,821,326,4057,2086,1585,1497,1190,962,753,562,403,287,202,140,203,13927,14253,15074
E02001982,Eastern Green & Tanyard Farm,405,184,605,586,686,627,571,529,564,561,429,372,364,310,477,6681,6865,7270
E02001983,Whoberley,345,180,659,571,642,619,598,546,597,579,428,410,345,259,353,6606,6786,7131
E02001984,Copsewood,551,283,1144,912,1079,997,840,734,795,713,603,370,348,310,351,9196,9479,10030
E02001985,Lower Stoke & Gosford Park,323,159,3852,1729,1099,858,626,451,391,324,234,136,102,85,133,10020,10179,10502
E02001986,Tile Hill,384,184,652,644,744,701,556,526,606,557,444,362,351,273,351,6767,6951,7335
E02001987,Chapelfields,184,77,1194,903,751,556,433,365,330,309,248,170,188,157,257,5861,5938,6122
E02001988,Central Coventry,200,116,7245,2993,1353,848,590,428,409,364,278,236,205,149,221,15319,15435,15635
E02001989,Earl Place & Lime Tree Park,317,166,934,558,593,567,452,394,402,386,351,282,280,166,239,5604,5770,6087
E02001990,Binley,486,202,661,568,656,673,711,624,666,719,638,549,517,400,601,7983,8185,8671
E02001991,Earlsdon & Canley Gardens,354,180,841,668,594,546,567,552,658,640,616,578,516,389,558,7723,7903,8257
E02001992,Ernesford Grange & Stoke Aldermoor,783,365,1065,841,994,1039,837,811,797,712,507,461,389,340,313,9106,9471,10254
E02001993,Canley & Westwood Heath,462,258,1996,980,711,629,536,507,541,547,475,368,342,252,305,8189,8447,8909
E02001994,Cheylesmore Daventry Road,473,218,728,688,891,838,727,585,633,529,455,375,414,309,416,7588,7806,8279
E02001995,Whitley & Tollbar End,408,180,1074,1059,1314,1206,858,566,577,479,391,328,296,255,354,8757,8937,9345
E02001996,Willenhall,538,227,699,628,769,677,665,558,514,486,353,300,223,168,243,6283,6510,7048
E02001997,Stivichall & Finham,414,200,640,450,516,570,601,575,630,647,593,512,480,398,652,7264,7464,7878
E02001998,Finham Park,362,176,482,345,336,387,458,421,482,415,362,297,326,316,400,5027,5203,5565
E02001999,Cannon Park & University,297,318,15203,2519,787,547,409,373,421,386,371,362,325,285,349,22337,22655,22952
E02006805,Holbrooks,585,270,960,723,867,872,778,650,670,590,464,339,280,198,321,7712,7982,8567
E02002000,Coseley Wallbrook,382,204,647,600,645,516,490,510,639,553,462,421,359,283,413,6538,6742,7124
E02002001,Sedgley East,303,145,486,431,342,398,347,384,529,439,405,325,286,237,336,4945,5090,5393
E02002002,Sedgley West,254,135,468,346,379,334,396,410,532,535,382,461,564,527,744,6078,6213,6467
E02002003,West Coseley,410,192,659,597,617,539,505,564,730,749,530,467,472,386,613,7428,7620,8030
E02002004,Woodsetton,450,198,640,514,591,577,471,510,590,541,443,381,316,270,386,6230,6428,6878
E02002005,Dudley Priory & Wrens Nest,648,286,849,751,804,767,616,637,668,597,435,398,296,271,309,7398,7684,8332
E02002006,Upper Gornal & Ruiton,292,138,505,439,490,428,406,385,534,492,405,330,261,244,283,5202,5340,5632
E02002007,Lower Gornal & The Straits,379,181,592,506,578,584,512,507,670,706,470,459,566,527,758,7435,7616,7995
E02002008,Dibdale,373,178,708,569,527,506,500,590,749,740,549,399,310,243,354,6744,6922,7295
E02002009,Kates Hill,490,231,658,541,642,580,549,502,494,414,348,282,233,165,209,5617,5848,6338
E02002010,New Dock & Eve Hill,453,247,815,703,697,681,660,608,616,558,470,334,283,238,392,7055,7302,7755
E02002011,Kingswinford North,253,130,391,341,401,359,293,354,457,456,389,421,420,385,421,5088,5218,5471
E02002012,Russell's Hall,389,199,720,721,657,589,498,575,655,628,481,357,361,307,504,7053,7252,7641
E02002013,Wall Heath,245,159,440,324,327,332,367,396,534,501,488,403,448,445,610,5615,5774,6019
E02002014,Dixons Green,467,245,773,660,743,711,663,526,546,486,419,285,298,172,289,6571,6816,7283
E02002015,Pensett & Kingswinford East,275,159,477,476,548,465,415,418,486,513,390,309,367,261,363,5488,5647,5922
E02002016,Brockmoor & Woodside,440,186,615,617,652,573,480,474,578,505,439,344,322,241,358,6198,6384,6824
E02002017,Netherton,431,200,725,617,632,593,535,544,604,571,453,414,360,287,402,6737,6937,7368
E02002018,Kingswinford South,414,221,663,451,435,502,576,601,723,672,583,513,671,589,759,7738,7959,8373
E02002019,Dudley Wood & Saltwells,437,213,680,519,606,549,488,468,611,503,461,365,324,261,333,6168,6381,6818
E02002020,Wordsley & Buckpool,398,195,650,505,577,560,534,622,810,644,576,504,636,539,697,7854,8049,8447
E02002021,Brierley Hill,343,154,625,673,687,613,490,464,537,509,322,312,287,225,303,6047,6201,6544
E02002022,Hawbush,421,224,646,646,716,633,531,574,688,575,451,416,374,225,286,6761,6985,7406
E02002023,Ashwood,220,100,396,305,353,340,290,338,434,361,328,260,336,373,278,4392,4492,4712
E02002024,Quarry Bank,406,180,658,565,635,581,525,594,615,587,540,463,409,348,433,6953,7133,7539
E02002025,Shell Corner & Hurst Green,424,195,705,685,730,665,579,506,632,663,490,399,354,306,362,7076,7271,7695
E02002026,Amblecote East,283,142,506,360,421,409,386,427,538,502,462,410,488,328,348,5585,5727,6010
E02002027,Withymoor Village,240,125,417,316,292,334,325,350,490,461,443,433,349,213,137,4560,4685,4925
E02002028,Wollaston,220,109,355,300,329,367,315,362,484,441,381,360,345,322,506,4867,4976,5196
E02002029,Quinton West,278,121,405,356,414,340,374,379,450,421,400,355,330,337,489,5050,5171,5449
E02002030,Amblecote West & Stambermill,341,164,509,451,491,468,447,451,484,464,377,345,379,304,327,5497,5661,6002
E02002031,Cradley West & Hayes Lane,313,139,537,464,530,382,416,374,416,432,397,386,308,209,245,5096,5235,5548
E02002032,Cradley East,518,252,845,691,799,723,646,646,695,666,531,435,447,360,410,7894,8146,8664
E02002033,Hawne,441,193,538,465,526,526,534,487,587,521,505,428,497,375,421,6410,6603,7044
E02002034,Stourbridge Town & Old Quarter,366,169,565,518,580,640,585,583,634,636,504,479,433,330,432,6919,7088,7454
E02002035,Halesowen East,249,145,416,300,342,373,407,364,443,454,422,433,451,349,433,5187,5332,5581
E02002036,Lye & Wynall,334,152,533,547,526,500,412,410,462,449,346,361,316,240,280,5382,5534,5868
E02002037,Norton North,247,138,367,308,383,359,331,376,449,463,393,363,396,297,334,4819,4957,5204
E02002038,Halesowen Town,445,218,701,632,660,668,594,630,691,613,576,514,541,549,485,7854,8072,8517
E02002039,Oldswinford & Pedmore,329,182,469,326,347,355,384,416,427,427,358,328,380,308,508,5033,5215,5544
E02002040,Norton South,255,135,358,261,260,305,350,344,446,496,422,425,500,377,524,5068,5203,5458
E02002041,Pedmore Fields,295,143,426,280,325,349,349,409,441,424,429,393,424,412,579,5240,5383,5678
E02002042,Hayley Green,390,183,521,394,393,551,515,521,561,622,540,525,522,439,548,6652,6835,7225
E02002043,Wood Green & Old Park,521,244,747,604,651,630,556,598,624,628,487,461,319,230,319,6854,7098,7619
E02002044,Yew Tree & Tamebridge,479,224,738,567,697,618,580,589,601,522,410,321,300,190,229,6362,6586,7065
E02002045,Woods & Mesty Croft,460,199,606,538,597,632,520,541,562,550,536,379,303,243,355,6362,6561,7021
E02002046,Friar Park,426,179,531,420,460,474,411,371,372,367,327,274,190,147,135,4479,4658,5084
E02002047,Wednesbury,331,151,512,493,508,458,431,451,533,482,480,416,383,345,436,5928,6079,6410
E02002048,Great Barr,307,159,503,416,415,447,443,441,581,541,392,389,352,315,515,5750,5909,6216
E02002049,Princes End & Willingsworth,314,148,521,426,441,423,350,395,434,469,347,281,296,220,239,4842,4990,5304
E02002051,Ocker Hill,416,179,483,450,477,483,363,376,421,381,311,233,206,160,173,4517,4696,5112
E02002052,Stone Cross & Hateley Heath,707,325,1050,795,953,914,867,839,771,756,553,474,429,292,468,9161,9486,10193
E02002053,Hamstead East,345,166,542,389,483,487,457,427,491,427,378,316,276,249,336,5258,5424,5769
E02002054,Hamstead West,299,153,459,365,440,416,376,411,410,415,333,268,274,266,357,4790,4943,5242
E02002055,Wednesbury South,632,306,979,739,963,934,830,799,819,702,597,521,435,303,397,9018,9324,9956
E02002056,Tibbington,613,288,918,738,795,757,694,640,677,556,511,367,330,264,317,7564,7852,8465
E02002057,Tipton,608,282,979,753,810,791,792,709,820,697,578,479,408,295,421,8532,8814,9422
E02002058,Great Bridge & Dudley Port,698,374,1147,985,1057,1125,1014,979,1067,859,688,509,428,301,384,10543,10917,11615
E02002059,West Bromwich North,686,337,1075,943,1026,1029,974,888,903,844,693,571,478,347,512,10283,10620,11306
E02002060,Greets Green West,528,228,715,538,645,713,635,558,446,442,385,315,204,142,273,6011,6239,6767
E02002061,Greets Green East,479,204,713,593,666,626,583,490,468,368,369,307,234,172,287,5876,6080,6559
E02002062,West Bromwich East & Kenrick Park,540,265,957,779,882,949,856,786,691,581,516,381,325,242,343,8288,8553,9093
E02002063,North Tividale,630,247,932,758,981,956,872,706,771,612,500,402,340,223,299,8352,8599,9229
E02002064,Tividale,714,353,1030,810,976,979,880,843,857,877,704,483,496,386,487,9808,10161,10875
E02002065,Smethwick North & West,1023,449,1850,1421,1473,1423,1370,1156,1040,846,619,509,373,291,399,12770,13219,14242
E02002066,Oldbury & Rood End,551,262,893,726,771,797,674,606,595,476,415,338,265,201,268,7025,7287,7838
E02002067,Rowley West,351,160,470,379,462,467,351,350,451,391,338,267,286,292,377,4881,5041,5392
E02002068,Smethwick East,1184,563,1924,1399,1576,1497,1473,1203,975,777,562,394,296,185,268,12529,13092,14276
E02002069,Whiteheath,385,163,574,524,627,491,445,455,550,491,366,313,319,245,327,5727,5890,6275
E02002070,Smethwick South,765,268,1153,878,1018,972,933,823,697,665,517,385,292,296,413,9042,9310,10075
E02002071,Rowley East,401,177,585,464,487,465,409,429,494,443,345,285,307,266,264,5243,5420,5821
E02002072,Langley Green,492,222,796,655,687,693,657,630,658,673,532,454,366,284,360,7445,7667,8159
E02002073,Warley East,571,248,836,593,645,661,647,622,641,596,449,340,340,254,340,6964,7212,7783
E02002074,Warley West,503,255,739,545,684,662,541,635,679,587,491,369,350,302,336,6920,7175,7678
E02002075,Blackheath,464,202,735,617,639,649,536,579,724,609,513,391,393,318,375,7078,7280,7744
E02002076,Bearwood & Warley Woods,614,257,900,926,1191,1130,1018,906,807,753,564,404,347,250,328,9524,9781,10395
E02002077,Old Hill,586,258,886,702,819,708,686,693,730,686,597,494,426,391,444,8262,8520,9106
E02002078,Warley South,341,148,531,394,432,510,483,467,512,475,414,295,343,287,344,5487,5635,5976
E02002079,Brandhall,502,252,755,563,643,686,600,534,611,636,546,445,428,308,381,7136,7388,7890
E02002080,Cradley Heath,427,177,573,508,537,543,481,496,560,515,375,351,314,241,354,5848,6025,6452
E02006810,Charlemont,499,274,923,713,778,768,741,720,803,704,660,564,574,444,589,8981,9255,9754
E02002081,Castle Bromwich West,217,107,367,347,369,335,305,291,386,451,434,401,407,301,331,4725,4832,5049
E02002082,Smith's Wood North,447,198,597,452,499,429,355,399,487,368,277,221,249,214,138,4685,4883,5330
E02002083,Castle Bromwich East,263,134,414,402,432,337,323,344,490,544,433,341,368,292,403,5123,5257,5520
E02002084,Smith's Wood South,419,165,555,532,614,497,402,427,507,406,310,306,297,222,238,5313,5478,5897
E02002085,Kingshurst,410,184,564,469,558,526,391,419,452,416,366,265,280,196,257,5159,5343,5753
E02002086,Chelmsley Wood West,269,147,531,494,503,398,294,335,453,429,321,252,286,235,216,4747,4894,5163
E02002087,Fordbridge,369,155,560,532,568,514,349,397,469,455,305,219,243,208,236,5055,5210,5579
E02002088,Chelmsley Wood East,536,227,804,738,849,736,572,640,723,630,468,344,409,375,382,7670,7897,8433
E02002089,Marston Green & Airport,365,206,618,527,596,511,453,543,682,612,488,351,462,394,403,6640,6846,7211
E02002090,Lyndon North,304,139,474,404,487,461,391,388,430,451,378,273,224,216,269,4846,4985,5289
E02002091,Elmdon Park,370,165,576,479,559,552,496,481,571,610,486,345,341,322,532,6350,6515,6885
E02002092,Lyndon South,368,173,584,477,546,577,499,472,563,514,411,371,345,319,430,6108,6281,6649
E02002093,Olton & Kineton Green,289,136,467,512,472,489,403,450,475,532,421,350,313,302,477,5663,5799,6088
E02002094,Ulverley Green & Langley,295,181,418,307,301,342,352,392,476,491,438,388,364,324,501,5094,5275,5570
E02002095,Elmdon Heath & Catherine-de-Barnes,413,217,639,516,596,630,610,576,623,586,574,510,544,430,476,7310,7527,7940
E02002096,Lode Heath,569,252,711,659,737,814,873,805,736,746,603,532,638,530,938,9322,9574,10143
E02002097,"Meriden, Hampton-in-Arden & Temple Balsall",347,188,502,325,435,448,462,527,627,624,595,484,468,419,426,6342,6530,6877
E02002098,Shirley East,598,273,703,548,639,686,761,707,774,730,596,453,479,378,700,8154,8427,9025
E02002099,Central Solihull & Sharmans Cross,431,181,510,332,325,430,486,520,616,543,473,417,399,365,608,6024,6205,6636
E02002101,Solihull Lodge,250,128,458,386,461,461,397,379,420,466,447,332,363,311,461,5342,5470,5720
E02002102,Blossomfield,510,234,638,488,551,657,741,709,630,655,512,440,473,346,672,7512,7746,8256
E02002103,Shirley Heath,201,110,365,343,392,407,423,366,389,484,446,395,454,335,520,5319,5429,5630
E02002104,Monkspath North,329,172,453,327,294,343,408,433,521,539,512,401,388,277,319,5215,5387,5716
E02002105,Balsall Common,405,199,590,382,338,428,539,598,692,688,528,463,531,489,595,6861,7060,7465
E02002106,Knowle,537,239,624,372,402,529,650,696,736,712,671,611,745,648,894,8290,8529,9066
E02002107,Monkspath South,267,108,337,292,332,437,410,379,426,451,459,377,384,259,293,4836,4944,5211
E02002108,Dorridge,611,271,713,436,409,577,708,704,741,813,703,560,609,495,702,8170,8441,9052
E02002109,"Dickens Heath, Cheswick Green & Hockley Heath",642,293,892,814,885,910,904,906,977,799,615,502,579,447,367,9597,9890,10532
E02006808,Shirley West,352,153,458,446,534,578,526,413,477,482,415,301,310,220,376,5536,5689,6041
E02002110,Brownhills West & Clayhanger,396,180,537,448,458,476,435,508,592,575,445,279,330,283,290,5656,5836,6232
E02002111,Brownhills,343,147,507,439,426,398,340,424,478,464,389,301,358,297,382,5203,5350,5693
E02002112,Pelsall North,269,127,421,289,299,363,304,350,454,408,363,321,331,283,286,4472,4599,4868
E02002113,Walsall Wood,310,178,498,415,461,411,357,404,514,484,418,328,328,256,358,5232,5410,5720
E02002114,Pelsall South,230,114,424,359,341,338,319,379,441,476,408,306,372,353,581,5097,5211,5441
E02002115,Little Bloxwich,365,169,624,444,507,428,410,425,511,496,386,324,345,281,440,5621,5790,6155
E02002116,Aldridge North,310,140,442,361,395,374,391,456,535,538,523,467,462,426,512,5882,6022,6332
E02002117,Bloxwich Central & North,301,146,523,399,388,372,353,397,523,579,499,401,394,215,311,5354,5500,5801
E02002118,Bloxwich North West,430,217,628,512,590,555,433,429,519,503,465,328,307,249,409,5927,6144,6574
E02002119,Shelfield,318,138,486,401,415,388,336,388,471,496,419,323,291,273,337,5024,5162,5480
E02002120,Ashmore,328,166,488,390,408,400,367,349,439,464,449,424,355,205,237,4975,5141,5469
E02002121,Blakenall North,446,202,600,477,558,506,384,425,457,441,337,298,245,217,337,5282,5484,5930
E02002122,Blakenall South,570,240,706,506,641,681,498,409,367,350,317,220,202,119,206,5222,5462,6032
E02002123,New Invention,290,147,538,418,481,473,431,386,426,444,382,321,326,292,377,5295,5442,5732
E02002124,Aldridge Central,293,147,439,419,460,394,357,394,516,495,465,362,410,367,709,5787,5934,6227
E02002125,Rushall,307,153,443,436,479,495,376,417,455,490,380,315,325,215,322,5148,5301,5608
E02002126,Bloxwich South,430,163,571,521,560,470,430,392,438,435,365,308,245,162,209,5106,5269,5699
E02002127,Walsall Ryecroft,696,299,929,762,861,864,746,620,606,501,407,365,261,175,269,7366,7665,8361
E02002128,Short Heath East,247,112,413,309,397,351,332,313,391,358,340,321,345,323,388,4581,4693,4940
E02002129,Short Heath West,290,130,417,338,467,391,366,359,457,455,374,401,365,295,345,5030,5160,5450
E02002130,Leamore,451,218,677,518,578,538,448,444,513,420,354,269,238,189,238,5424,5642,6093
E02002131,Aldridge South,379,177,571,375,394,458,497,472,669,621,556,468,497,444,624,6646,6823,7202
E02002132,Bentley,392,179,532,430,518,497,460,374,423,416,361,348,297,199,280,5135,5314,5706
E02002133,Walsall North East,312,151,522,556,574,545,497,456,572,475,422,390,319,269,370,5967,6118,6430
E02002134,Willenhall Park,564,225,809,666,794,715,696,591,647,590,526,357,319,264,302,7276,7501,8065
E02002135,Walsall West,555,254,805,735,788,735,720,560,525,409,366,301,206,180,195,6525,6779,7334
E02002136,Willenhall Town,456,181,698,569,688,638,610,551,589,523,441,364,297,224,234,6426,6607,7063
E02002137,Streetly North,311,116,402,293,337,349,359,416,483,455,423,342,379,371,618,5227,5343,5654
E02002138,Walsall East,397,208,616,445,463,461,478,464,420,383,332,272,264,229,308,5135,5343,5740
E02002139,Walsall Central,614,316,1254,1001,1063,1001,972,745,747,577,508,372,281,180,295,8996,9312,9926
E02002140,Pleck,605,269,913,746,874,803,709,644,587,480,410,333,312,215,296,7322,7591,8196
E02002141,Streetly South,296,139,420,354,427,472,430,390,512,493,404,300,352,360,505,5419,5558,5854
E02002142,Darlaston East,496,234,736,564,613,648,607,468,501,457,390,289,243,137,204,5857,6091,6587
E02002143,Palfrey,850,403,1224,839,992,1010,986,761,640,474,421,335,264,201,266,8413,8816,9666
E02002144,Walsall South East,343,182,505,396,440,434,471,476,509,467,380,445,449,336,536,5844,6026,6369
E02002145,Darlaston Central,529,224,758,630,695,727,573,555,566,469,408,335,260,188,240,6404,6628,7157
E02002146,The Delves,425,235,700,445,515,549,479,451,440,397,355,289,239,183,252,5294,5529,5954
E02002147,Darlaston West,542,255,794,742,791,739,592,549,616,514,433,329,304,234,343,6980,7235,7777
E02002148,Pheasey & Sutton Road,530,252,863,669,795,752,745,713,867,921,669,495,509,475,854,9327,9579,10109
E02002149,Bushbury,505,267,705,664,806,727,592,618,740,820,675,580,526,433,615,8501,8768,9273
E02002150,Fordhouses,365,160,491,386,446,444,403,399,450,418,373,299,240,175,281,4805,4965,5330
E02002151,Pendeford,300,143,476,409,429,428,420,399,394,395,419,325,254,165,156,4669,4812,5112
E02002152,Bushbury Hill,474,208,619,459,527,508,473,426,457,446,317,242,226,164,289,5153,5361,5835
E02002153,Ashmore Park,310,165,555,545,573,483,414,463,596,575,524,342,338,295,555,6258,6423,6733
E02002154,Oxley Park,433,223,540,595,746,681,559,473,502,470,372,293,236,149,222,5838,6061,6494
E02002155,Low Hill,602,237,644,522,652,593,516,464,407,365,280,226,209,135,215,5228,5465,6067
E02002156,Wood End,442,193,673,547,661,624,547,562,659,691,558,469,381,298,465,7135,7328,7770
E02002157,Tettenhall North,407,210,613,544,531,548,490,540,701,558,517,407,379,283,484,6595,6805,7212
E02002158,Wednesfield North East,372,180,556,515,564,491,463,474,594,583,491,388,394,315,564,6392,6572,6944
E02002159,Park Lane,501,190,732,529,606,579,525,492,558,399,291,189,197,123,153,5373,5563,6064
E02002160,Wednesfield Town,407,200,616,527,571,540,562,592,608,521,464,369,378,298,348,6394,6594,7001
E02002161,Whitmore Reans & Dunstall Hill,470,214,694,679,750,746,699,583,502,456,340,241,163,116,152,6121,6335,6805
E02002162,Tettenhall South,377,182,505,370,429,461,532,525,556,517,499,472,507,470,881,6724,6906,7283
E02002163,Heath Town,738,309,1057,1088,1289,1227,1048,953,888,774,589,434,304,224,299,10174,10483,11221
E02002164,Waterloo Road,394,167,987,969,1168,1020,801,615,523,356,304,168,117,93,144,7265,7432,7826
E02002165,West Park,338,181,682,770,794,772,704,665,624,564,475,340,260,157,306,7113,7294,7632
E02002166,East Park,649,298,888,735,825,795,697,714,753,645,527,438,388,355,436,8196,8494,9143
E02002167,Castlecroft,312,143,455,366,426,409,422,458,514,525,432,420,419,342,432,5620,5763,6075
E02002168,Wolverhampton Central,696,293,1419,1448,1552,1338,1017,934,794,700,542,402,280,181,353,10960,11253,11949
E02002169,Compton & Merryhill North,462,214,613,442,494,573,582,680,659,667,560,575,598,468,704,7615,7829,8291
E02002170,Bilston North West,373,175,590,451,456,467,444,452,491,502,389,316,279,212,306,5355,5530,5903
E02002171,Bilston North East,448,211,644,548,664,622,605,490,571,501,439,404,409,285,364,6546,6757,7205
E02002174,Bradmore,364,193,568,466,546,558,566,551,592,594,546,446,419,310,392,6554,6747,7111
E02002175,Bilston Lunt & Loxdale,511,235,684,628,756,716,631,532,564,500,418,391,354,229,321,6724,6959,7470
E02002176,Merryhill South,387,189,660,499,528,550,539,562,621,557,456,418,431,325,353,6499,6688,7075
E02002177,Ettingshall,685,281,1035,973,1200,1173,955,818,809,668,589,451,349,262,346,9628,9909,10594
E02002178,Goldthorn Park,400,193,635,563,626,671,643,553,615,591,541,560,442,322,544,7306,7499,7899
E02002179,Upper Penn,334,154,446,362,399,426,455,473,520,491,422,381,369,243,424,5411,5565,5899
E02002180,Ettingshall Park,371,156,577,412,441,465,439,437,484,439,396,335,309,264,441,5439,5595,5966
E02002181,Bradley,533,240,713,608,719,703,579,576,609,507,408,334,314,251,302,6623,6863,7396
E02002182,Woodcross,357,179,667,458,471,460,440,478,500,442,409,382,313,221,320,5561,5740,6097
E02006894,Blakenhall,1064,466,1698,1419,1551,1526,1356,1209,1081,863,753,642,507,334,542,13481,13947,15011
E02002652,Kingswood,1004,420,1351,1614,1784,1541,1300,1156,1061,843,677,497,379,206,173,12582,13002,14006
E02002653,Bransholme Central,595,264,765,620,644,635,487,517,539,600,402,348,343,226,300,6426,6690,7285
E02002654,Orchard Park,648,284,799,647,749,658,481,479,456,431,414,266,218,135,212,5945,6229,6877
E02002655,Bransholme East,605,251,783,630,747,665,554,598,671,563,458,370,388,255,264,6946,7197,7802
E02002656,Haworth Park,174,79,268,242,272,262,262,287,362,456,405,390,403,320,486,4415,4494,4668
E02002657,Bransholme West,299,145,509,400,549,501,449,470,501,522,511,536,550,343,356,6197,6342,6641
E02002658,Sutton North,271,126,451,365,408,386,377,390,491,522,479,496,427,271,410,5473,5599,5870
E02002659,Greenwood,688,298,1052,842,957,861,738,694,716,762,612,510,373,258,377,8752,9050,9738
E02002660,Bilton Grange,385,161,557,481,535,512,417,398,471,520,455,415,416,237,348,5762,5923,6308
E02002661,Longhill,482,233,671,567,649,586,499,529,567,516,525,480,411,260,431,6691,6924,7406
E02002662,Ings,355,171,542,523,537,508,354,413,531,587,543,467,435,295,473,6208,6379,6734
E02002663,University & Newland North,224,105,2538,957,558,470,415,334,321,325,283,244,216,149,138,6948,7053,7277
E02002664,Sutton South,349,183,538,392,423,460,467,490,600,577,548,437,469,300,336,6037,6220,6569
E02002665,Bricknell East,420,179,625,530,574,555,548,553,576,585,552,441,442,311,384,6676,6855,7275
E02002666,Newland South,305,122,1547,1490,1076,991,719,621,555,437,367,269,191,135,175,8573,8695,9000
E02002667,Stoneferry & Sutton Fields,295,124,505,542,646,570,469,489,539,539,474,376,336,210,275,5970,6094,6389
E02002668,Southcoates East,551,258,682,586,741,679,491,501,523,592,478,424,401,250,344,6692,6950,7501
E02002669,Newland Avenues,328,177,1076,1033,872,795,724,647,653,530,392,326,247,158,154,7607,7784,8112
E02002670,Bricknell West,416,187,562,518,576,531,465,485,596,612,519,403,404,278,428,6377,6564,6980
E02002671,Southcoates Central & Docks,434,204,846,813,839,848,688,637,694,675,592,390,316,228,319,7885,8089,8523
E02002672,Greatfield,503,210,691,680,740,590,420,387,453,458,393,298,249,145,263,5767,5977,6480
E02002673,Southcoates West,332,159,636,592,656,545,475,530,540,532,453,367,348,223,275,6172,6331,6663
E02002674,Derringham,245,122,434,596,552,433,394,424,474,521,410,328,334,228,288,5416,5538,5783
E02002675,Sculcoates,486,201,1021,956,978,909,852,758,729,596,476,377,286,176,190,8304,8505,8991
E02002676,Chanterlands Avenue,314,168,603,747,771,673,604,549,564,525,416,310,283,188,252,6485,6653,6967
E02002677,Drypool & Victoria Dock,316,169,616,715,774,696,589,653,627,642,517,377,346,220,246,7018,7187,7503
E02002678,Newington,402,192,721,833,845,725,599,603,604,638,512,328,296,172,229,7105,7297,7699
E02002679,East Ella,360,169,491,446,550,540,455,476,528,587,579,485,442,311,418,6308,6477,6837
E02002680,Hull City Centre,299,155,1196,1333,1129,1067,810,778,650,513,511,367,316,198,283,9151,9306,9605
E02002681,Boulevard & St Andrew's Quay,495,253,882,1013,1032,992,767,706,722,599,527,361,250,178,233,8262,8515,9010
E02002682,Gipsyville,595,239,823,815,1018,922,790,694,688,698,603,493,408,242,282,8476,8715,9310
E02006813,Anlaby Park & Pickering,389,202,590,528,588,539,484,509,563,631,577,471,480,314,529,6803,7005,7394
E02002684,Bridlington North & Bempton,316,148,497,446,420,425,387,456,635,755,867,971,1149,927,1013,8948,9096,9412
E02002685,Bridlington East & Flamborough,274,141,410,371,380,304,287,400,539,645,652,730,820,669,745,6952,7093,7367
E02002686,Bridlington West,459,210,554,489,498,449,404,440,514,525,457,489,546,409,522,6296,6506,6965
E02002687,Bridlington Central,265,124,410,334,332,355,259,332,452,505,489,437,425,361,408,5099,5223,5488
E02002688,Bridlington Hilderthorpe,259,135,437,364,327,358,314,365,478,466,416,389,339,266,308,4827,4962,5221
E02002689,"Burton Agnes, Rudston & Langtoft",222,103,329,241,259,218,260,335,473,521,509,514,491,378,447,4975,5078,5300
E02002691,Driffield West & Huggate,350,173,489,383,405,418,441,512,616,692,650,608,659,516,610,6999,7172,7522
E02002692,Stamford Bridge & Sutton Upon Derwent,399,165,553,484,588,608,656,658,783,787,704,597,661,516,541,8136,8301,8700
E02002693,"Skipsea, Beeford & Brandesburton",284,128,404,348,322,346,358,418,622,670,668,621,639,474,471,6361,6489,6773
E02002694,Pocklington,602,314,919,860,815,748,747,833,997,1035,878,839,918,697,791,11077,11391,11993
E02002695,Hornsea,303,184,523,351,329,378,365,482,536,692,647,710,833,636,763,7245,7429,7732
E02002696,"Cherry Burton, Leconfield & Middleton",257,228,733,358,380,340,371,398,499,558,482,406,456,324,343,5648,5876,6133
E02002697,Leven & Tickton,352,181,453,317,337,377,407,517,637,656,592,578,665,495,538,6569,6750,7102
E02002698,Market Weighton,377,162,497,482,552,505,545,538,616,628,574,498,597,417,488,6937,7099,7476
E02002699,Molescroft,447,204,604,418,510,524,601,708,724,803,752,659,713,590,781,8387,8591,9038
E02002700,Beverley North,320,140,432,393,410,401,367,420,439,459,378,327,299,224,313,4862,5002,5322
E02002701,"Holme, Melbourne & Bubwith",404,193,496,391,437,466,480,543,737,829,768,701,673,435,434,7390,7583,7987
E02002702,Beverley South,326,184,628,598,569,531,505,593,779,848,807,715,694,517,803,8587,8771,9097
E02002703,"Walkington, Bishop Burton & Woodmansey",418,300,717,437,472,470,495,637,856,871,713,668,622,439,584,7981,8281,8699
E02002704,Aldbrough & Sproatley,295,149,418,315,359,365,349,414,522,626,667,659,708,433,467,6302,6451,6746
E02002705,Cottingham West,305,136,644,541,491,436,435,430,477,574,492,520,562,405,617,6624,6760,7065
E02002706,Cottingham East,310,165,465,393,488,479,437,472,571,585,566,445,491,364,563,6319,6484,6794
E02002707,"South Cave, Newbald & Little Weighton",301,161,559,528,543,512,473,575,599,708,608,472,496,421,474,6968,7129,7430
E02002708,Cottingham South & North Ella,214,99,320,283,285,269,319,358,376,455,485,420,499,378,704,5151,5250,5464
E02002709,Gilberdyke & North Cave,338,181,514,375,440,458,402,481,589,698,587,538,522,361,480,6445,6626,6964
E02002710,Willerby,339,140,495,344,388,418,443,471,575,619,536,414,448,380,562,6093,6233,6572
E02002711,Kirk Ella,317,180,468,304,351,432,445,497,604,676,551,573,634,488,768,6791,6971,7288
E02002712,Hedon & Preston,247,114,456,373,361,369,376,492,552,587,544,551,649,438,601,6349,6463,6710
E02002714,Withernsea West & Keyingham,316,159,466,356,438,428,387,465,578,676,722,648,664,451,478,6757,6916,7232
E02002715,Brough,783,379,927,705,776,887,897,1118,1165,961,786,605,661,502,686,10676,11055,11838
E02002716,Burstwick & Thorngumbald,378,213,609,437,436,429,514,579,652,632,625,538,637,450,584,7122,7335,7713
E02002717,Hessle East & Anlaby South,339,160,548,509,626,521,471,490,576,557,520,448,392,282,452,6392,6552,6891
E02002718,North Ferriby & Swanland,420,203,497,285,338,409,487,596,694,648,539,510,636,501,642,6782,6985,7405
E02002719,Hessle West,275,130,397,340,459,434,394,429,507,545,450,385,371,283,571,5565,5695,5970
E02002720,Howden South & Goole North,330,164,477,423,450,440,477,496,619,611,613,458,504,366,519,6453,6617,6947
E02002721,"Howden North, Eastrington & Swinefleet",284,152,508,371,405,373,379,441,588,576,534,458,429,311,405,5778,5930,6214
E02002722,Withernsea East & Patrington,420,187,533,421,458,481,416,488,646,707,702,758,804,528,552,7494,7681,8101
E02002723,Goole West,379,149,576,630,708,663,542,601,610,600,524,438,450,373,464,7179,7328,7707
E02002724,Goole East,484,230,808,790,864,799,638,588,596,616,520,434,397,266,300,7616,7846,8330
E02002725,Snaith,311,161,495,343,382,392,391,451,615,588,471,484,448,315,390,5765,5926,6237
E02006814,Anlaby Common,316,167,547,537,569,500,461,477,557,563,574,455,552,366,461,6619,6786,7102
E02006891,Driffield East & Nafferton,314,182,505,417,443,430,400,482,651,725,659,584,605,443,530,6874,7056,7370
E02006892,Driffield Central,254,110,384,355,395,378,335,352,418,481,407,363,465,349,544,5226,5336,5590
E02002726,Immingham & Habrough,577,260,789,656,723,684,700,670,795,771,710,639,605,475,574,8791,9051,9628
E02002727,Grimsby East Marsh & Port,243,136,520,431,508,455,365,356,396,409,316,226,209,146,190,4527,4663,4906
E02002728,Grimsby West Marsh,386,179,652,717,766,630,549,539,573,548,425,326,275,167,204,6371,6550,6936
E02002729,Great Coates & The Willows,279,119,428,331,353,385,325,318,449,495,429,379,368,252,246,4758,4877,5156
E02002730,Sidney Park,447,229,666,567,640,589,462,472,487,489,416,276,236,154,138,5592,5821,6268
E02002731,New Clee,364,140,615,541,556,455,386,319,387,330,303,193,150,94,110,4439,4579,4943
E02002732,"Laceby, Healing & Stallingborough",425,210,544,404,471,480,485,556,649,668,571,535,448,373,488,6672,6882,7307
E02002733,Littlefield North,238,134,404,413,457,380,346,333,478,461,401,311,292,207,329,4812,4946,5184
E02002734,Yarborough,268,112,397,330,469,397,314,324,378,377,360,280,291,219,349,4485,4597,4865
E02002735,Cleethorpes North,214,113,379,392,393,325,300,336,403,392,337,273,253,155,282,4220,4333,4547
E02002736,Holme Hill,356,165,621,520,587,449,410,373,433,367,298,206,152,99,106,4621,4786,5142
E02002737,Weelsby & Old Clee,329,163,503,453,599,477,396,407,570,647,520,436,364,249,425,6046,6209,6538
E02002738,Laceby Acres & Wybers Wood,333,143,462,420,511,475,415,389,479,517,520,439,457,285,294,5663,5806,6139
E02002739,Cleethorpes Beacon Hill,244,123,349,368,415,424,326,328,428,448,427,370,351,221,366,4821,4944,5188
E02002740,Littlefield South & Grange,313,147,418,361,444,409,327,332,400,402,343,282,287,179,277,4461,4608,4921
E02002741,Wellow,465,218,663,559,653,623,581,622,655,689,582,493,448,296,494,7358,7576,8041
E02002742,Cleethorpes Haverstoe,224,120,332,249,302,287,306,384,383,413,390,363,436,303,403,4551,4671,4895
E02002743,Cleethorpes West,224,115,293,232,300,298,266,305,315,446,408,410,491,387,587,4738,4853,5077
E02002744,Nunsthorpe,519,230,691,543,575,536,409,436,473,464,381,342,315,159,211,5535,5765,6284
E02002745,Humberston,254,134,415,264,305,328,309,437,601,662,637,506,626,591,703,6384,6518,6772
E02002746,Scartho,483,225,626,529,706,688,549,601,674,732,669,530,534,486,668,7992,8217,8700
E02002747,New Waltham,466,228,612,497,500,544,514,630,742,762,612,535,608,526,697,7779,8007,8473
E02002748,Waltham & East Ravendale,318,156,455,382,389,415,433,400,629,773,626,625,628,477,753,6985,7141,7459
E02002749,Barton upon Humber,546,246,824,740,753,752,701,733,937,892,814,795,729,540,612,9822,10068,10614
E02002750,"Goxhill, Barrow & New Holland",317,127,342,302,344,309,367,452,565,598,499,419,466,304,332,5299,5426,5743
E02002751,Winterton & Winteringham,313,146,447,366,380,374,363,371,497,521,457,399,462,344,360,5341,5487,5800
E02002752,"Barnetby, Ulceby & Killingholme",325,158,408,350,390,436,374,461,612,632,623,487,450,307,319,5849,6007,6332
E02002753,"Burton upon Stather, Alkborough & Gunness",280,148,497,454,497,491,396,524,675,687,696,592,632,515,706,7362,7510,7790
E02002754,Crowle & Keadby,403,156,530,464,455,537,457,482,695,712,667,532,552,375,428,6886,7042,7445
E02002755,Scunthorpe North,367,184,703,680,836,791,628,545,552,567,421,310,294,225,345,6897,7081,7448
E02002756,Scunthorpe Central & Crosby,640,310,1155,1084,1156,1159,923,780,696,527,416,333,261,147,243,8880,9190,9830
E02002757,Scunthorpe Berkeley,306,168,477,431,572,497,414,386,489,418,383,291,280,251,357,5246,5414,5720
E02002758,Scunthorpe Frodingham,341,184,565,513,525,509,452,384,460,433,390,324,248,182,216,5201,5385,5726
E02002759,Brigg & South Ferriby,434,226,602,471,523,530,493,604,761,857,766,665,748,515,691,8226,8452,8886
E02002760,Scunthorpe Central Park,279,151,456,386,347,377,347,339,418,491,400,378,398,225,323,4885,5036,5315
E02002761,Broughton & Appleby,262,128,430,365,390,360,315,366,573,575,499,411,429,337,390,5440,5568,5830
E02002762,Scunthorpe Lincoln Gardens,341,175,533,437,451,447,436,370,460,516,385,380,308,221,414,5358,5533,5874
E02002763,Scunthorpe Lakeside,480,209,685,708,808,689,565,541,557,535,486,371,308,232,303,6788,6997,7477
E02002764,Scunthorpe Westcliff,441,210,552,418,475,488,367,379,413,365,316,245,247,191,220,4676,4886,5327
E02002765,Scunthorpe Ashby,344,163,430,444,491,456,351,345,441,498,408,351,313,239,341,5108,5271,5615
E02002766,Scunthorpe Bottesford,506,224,655,484,610,658,582,564,620,562,514,500,538,442,574,7303,7527,8033
E02002767,Scunthorpe Yaddlethorpe,245,120,420,362,411,320,371,408,509,503,527,468,511,368,489,5667,5787,6032
E02002768,Epworth & Bracon,374,168,508,374,375,392,478,498,570,680,602,533,557,385,457,6409,6577,6951
E02002769,Messingham & Scawby,212,109,318,237,268,272,264,331,456,540,482,398,471,394,468,4899,5008,5220
E02002770,Kirton in Lindsey & Hibaldstow,343,149,459,348,422,413,391,435,558,607,502,515,514,394,433,5991,6140,6483
E02002771,"Westwoodside, Haxey & Owston Ferry",330,164,456,350,351,324,339,455,577,720,599,521,591,413,458,6154,6318,6648
E02002772,Strensall,403,196,482,313,360,384,458,534,554,575,453,398,394,290,354,5549,5745,6148
E02002773,Haxby,258,132,273,220,298,329,362,358,377,391,419,424,568,433,514,4966,5098,5356
E02002774,Wigginton,280,137,318,209,293,393,439,388,463,414,486,480,500,377,561,5321,5458,5738
E02002775,New Earswick,272,140,392,286,347,316,333,338,442,402,387,364,428,351,577,4963,5103,5375
E02002776,Huntington,293,159,434,483,498,421,451,422,485,503,468,373,415,360,471,5784,5943,6236
E02002777,Clifton Without & Skelton,424,196,645,685,807,685,658,659,703,700,560,443,353,278,348,7524,7720,8144
E02002778,Rawcliffe & Clifton South,336,228,705,484,533,544,518,562,764,649,560,449,470,351,561,7150,7378,7714
E02002779,Heworth North & Stockton,364,165,913,538,601,596,593,604,736,769,706,567,640,499,684,8446,8611,8975
E02002780,Clifton North,374,181,1224,874,790,760,585,526,551,495,385,290,259,178,231,7148,7329,7703
E02002781,Heworth South & The Groves,324,154,1947,1135,954,863,689,522,597,503,391,310,280,180,292,8663,8817,9141
E02002782,"Poppleton, Rufforth & Askham",302,157,469,249,267,341,431,445,502,515,404,384,424,338,602,5371,5528,5830
E02002783,Acomb,539,261,722,593,786,806,781,744,760,764,652,575,529,415,540,8667,8928,9467
E02002784,York City Centre,263,132,3192,2025,1349,1036,803,743,705,734,592,474,418,314,357,12742,12874,13137
E02002785,Osbaldwick,369,150,1063,538,584,556,481,472,522,530,466,338,405,319,555,6829,6979,7348
E02002786,Tang Hall,424,173,2255,1163,912,767,609,509,499,457,364,277,274,185,220,8491,8664,9088
E02002787,Holgate West,359,163,678,699,856,736,754,653,687,620,528,440,419,303,482,7855,8018,8377
E02002788,Holgate East,338,151,696,842,830,796,695,627,666,645,482,399,365,241,234,7518,7669,8007
E02002789,"Westfield, Chapelfields & Foxwood",519,245,775,734,901,873,705,579,631,572,500,388,378,251,330,7617,7862,8381
E02002790,Fulford Road & Clementhorpe,418,165,2867,1834,1221,998,900,724,759,637,493,391,434,308,424,11990,12155,12573
E02002791,"Dunnington, Elvington & Wheldrake",369,170,461,255,291,306,369,446,592,532,456,405,463,418,584,5578,5748,6117
E02002792,South Bank & Dringhouses,358,149,624,582,583,620,662,575,621,577,500,396,375,300,466,6881,7030,7388
E02002793,Woodthorpe & Acomb Park,350,186,689,614,667,682,578,575,670,693,648,583,638,427,540,8004,8190,8540
E02002794,"Fulford, Heslington & University",288,170,6302,1828,621,456,433,439,399,398,320,287,344,275,430,12532,12702,12990
E02002795,Bishopthorpe & Copmanthorpe,436,221,464,270,324,436,563,607,637,662,623,612,718,529,610,7055,7276,7712
E02005742,Ingleton & High Bentham,293,147,449,312,360,356,369,429,595,656,693,632,590,509,542,6492,6639,6932
E02005743,"Grassington, Upper Wharfedale & Gargrave",168,84,276,198,193,186,213,275,410,512,460,432,445,369,553,4522,4606,4774
E02005744,"Settle, Hellifield & Horton",369,197,507,356,314,349,344,452,628,719,692,641,669,539,691,6901,7098,7467
E02005745,Skipton North & Barden Fell,257,131,342,200,219,259,290,325,451,465,457,416,436,342,407,4609,4740,4997
E02005746,Skipton Town & East,251,127,386,388,443,438,445,470,483,544,514,480,475,328,435,5829,5956,6207
E02005747,Skipton South,338,157,557,554,576,572,475,428,526,488,436,384,391,280,396,6063,6220,6558
E02005748,"Carleton, Cowling & Cononley",367,148,500,354,405,434,484,516,699,692,645,567,544,365,414,6619,6767,7134
E02005749,Sutton & Crosshills,476,196,685,513,547,502,618,692,808,829,696,699,693,579,743,8604,8800,9276
E02005750,Great Ayton & Stokesley,305,193,516,373,404,339,406,447,588,690,650,556,588,554,662,6773,6966,7271
E02005751,Rudby & Ingleby,331,180,492,377,315,372,396,472,688,855,806,659,792,758,752,7734,7914,8245
E02005752,"Brompton, Appleton & Thimbleby",244,138,406,342,345,350,389,413,571,654,552,533,546,371,390,5862,6000,6244
E02005753,Northallerton,622,276,908,777,900,831,758,789,1000,1006,897,834,842,594,979,11115,11391,12013
E02005754,Northallerton South & Leeming Bar,284,133,381,319,353,331,387,407,511,689,642,620,683,525,646,6494,6627,6911
E02005755,Bedale & Snape,279,124,398,369,384,375,330,338,553,626,555,460,473,344,536,5741,5865,6144
E02005756,"Leeming, Pickhill & Thornton",246,117,833,665,605,579,483,424,554,546,481,460,423,291,301,6645,6762,7008
E02005757,Thirsk North,314,142,535,466,473,475,507,529,664,750,673,602,572,469,654,7369,7511,7825
E02005758,Thirsk South & Coxwold,426,191,616,482,590,567,503,527,657,760,685,584,618,456,588,7633,7824,8250
E02005759,Easingwold & Stillington,382,218,565,449,452,430,471,506,677,795,699,654,725,558,798,7779,7997,8379
E02005760,"Linton, Tollerton & Raskelf",294,159,419,270,301,300,352,410,576,600,552,385,390,263,286,5104,5263,5557
E02005761,"Masham, Kirkby Malzeard & North Stainley",263,131,336,233,239,268,288,369,475,529,474,391,459,345,377,4783,4914,5177
E02005762,Ripon North & West,338,171,440,268,282,294,360,395,417,402,405,297,409,293,480,4742,4913,5251
E02005763,"Dishforth, Baldersby & Markington",304,136,852,706,634,602,517,437,565,537,497,448,454,369,369,6987,7123,7427
E02005764,Ripon South & East,497,257,713,560,599,655,651,683,812,787,743,605,642,570,815,8835,9092,9589
E02005765,Boroughbridge & Marton-cum-Grafton,296,146,498,375,441,379,407,450,583,676,593,539,490,365,548,6344,6490,6786
E02005766,Pateley Bridge & Nidd Valley,270,143,400,236,306,281,337,378,537,583,535,484,501,361,403,5342,5485,5755
E02005767,Knaresborough North,416,195,486,302,319,419,462,513,641,659,587,520,517,373,495,6293,6488,6904
E02005768,Killinghall & Hampsthwaite,334,1145,500,495,536,500,502,519,536,527,519,383,378,286,324,6005,7150,7484
E02005769,Knaresborough Central,311,178,481,421,490,454,412,428,524,612,460,435,455,325,532,6029,6207,6518
E02005770,Bilton,374,186,500,526,681,694,616,620,671,747,625,532,573,422,556,7763,7949,8323
E02005771,Saltergate,375,180,462,484,615,709,600,542,578,550,507,406,370,238,297,6358,6538,6913
E02005772,Knaresborough South & Follifoot,263,134,393,268,306,329,348,388,482,551,550,469,538,379,471,5472,5606,5869
E02005773,Harrogate East,397,208,661,663,823,763,708,657,752,680,570,461,405,262,456,7861,8069,8466
E02005774,Starbeck,405,192,693,619,757,674,657,631,762,726,621,500,485,343,572,8040,8232,8637
E02005775,Central Harrogate,357,213,827,889,865,856,809,745,860,793,653,473,479,359,610,9218,9431,9788
E02005776,"Ouseburn, Hammerton & Tockwith",749,503,1255,546,504,507,525,643,701,844,698,570,579,415,432,8219,8722,9471
E02005777,Hookstone,445,211,474,389,417,516,610,609,693,649,567,500,523,395,602,6944,7155,7600
E02005778,"Menwith, Beckwithshaw & Denton Moor",299,146,457,259,299,292,343,419,596,669,579,430,428,391,453,5615,5761,6060
E02005779,Stray,378,189,470,480,429,448,515,586,647,664,509,449,444,387,690,6718,6907,7285
E02005780,Harrogate West & Pannal,774,369,794,469,477,637,755,908,980,915,708,598,696,569,954,9460,9829,10603
E02005781,"Spofforth, Burn Bridge & Huby",323,130,378,232,263,333,406,380,465,485,472,398,462,370,461,5105,5235,5558
E02005782,North Richmondshire,301,182,472,284,307,324,369,497,639,724,748,660,635,463,548,6670,6852,7153
E02005783,Richmond Town,390,199,558,302,357,422,479,483,640,691,684,602,585,479,634,6916,7115,7505
E02005784,Catterick & Brompton-on-Swale,243,110,357,295,295,296,293,321,465,454,407,328,373,266,343,4493,4603,4846
E02005785,Catterick Garrison & Colburn,673,629,3860,2503,2108,1558,1054,719,861,636,500,362,328,239,310,15038,15667,16340
E02005786,Upper Dales,173,89,295,218,264,253,270,345,484,649,605,522,556,391,410,5262,5351,5524
E02005787,"Leyburn, Middleham & Tunstall",311,159,563,365,402,375,391,505,632,758,801,735,751,541,670,7489,7648,7959
E02005788,Kirkbymoorside & Moors,266,131,376,271,278,257,297,333,497,589,529,508,589,381,522,5427,5558,5824
E02005789,Pickering & Thornton Dale,405,234,617,463,482,472,491,575,802,906,857,881,1012,789,981,9328,9562,9967
E02005790,Helmsley & Ampleforth,423,297,399,307,358,375,329,385,533,649,636,564,501,435,634,6105,6402,6825
E02005791,Rillington & Sherburn,292,155,492,352,407,387,351,416,605,672,609,524,457,331,343,5946,6101,6393
E02005794,"Sheriff Hutton, Slingsby & Swinton",357,157,530,421,395,503,513,581,762,913,783,734,750,551,610,8046,8203,8560
E02006870,Malton & Norton,680,290,1042,971,1122,1049,945,976,1075,1044,952,800,813,662,937,12388,12678,13358
E02005795,Whitby West,266,129,447,355,375,376,360,437,515,604,619,532,543,435,569,6167,6296,6562
E02005796,Esk Valley & Runswick Coast,235,127,433,319,329,278,312,359,528,623,622,590,590,360,450,5793,5920,6155
E02005797,Whitby South & East,281,140,419,354,401,381,341,352,411,544,488,461,468,322,291,5233,5373,5654
E02005798,"Burniston, Sleights & Fylingdales",367,177,412,304,366,359,368,457,648,758,752,749,777,591,613,7154,7331,7698
E02005799,Newby & Scalby,445,198,516,386,474,485,457,510,646,723,691,694,815,610,953,7960,8158,8603
E02005800,Scarborough Town & North Bay,329,167,656,563,578,579,517,518,663,629,551,463,387,292,387,6783,6950,7279
E02005801,Barrowcliff & Northstead,329,185,468,314,385,354,305,343,396,392,371,285,319,228,305,4465,4650,4979
E02005802,Scarborough Central,376,211,698,627,680,554,495,542,599,534,469,352,321,243,315,6429,6640,7016
E02005803,Falsgrave,406,181,628,538,606,511,505,571,703,742,696,638,649,484,699,7970,8151,8557
E02005804,Ramshill & South Cliff,233,193,607,596,648,538,513,508,571,677,674,577,592,391,669,7561,7754,7987
E02005805,Wheatcroft & Cayton,253,128,451,408,444,370,343,457,548,647,682,571,643,570,580,6714,6842,7095
E02005806,"Eastfield, Crossgates & Seamer",507,206,649,564,677,556,498,459,560,565,489,379,395,278,317,6386,6592,7099
E02005807,Ayton & Snainton,283,146,422,296,344,342,324,428,474,552,529,548,584,404,481,5728,5874,6157
E02005808,Filey & Hummanby,418,222,586,530,566,533,456,543,764,936,1059,1011,1142,938,1118,10182,10404,10822
E02005809,Tadcaster,326,164,446,369,436,376,405,471,577,641,562,440,467,374,480,6044,6208,6534
E02005810,"Church Fenton, Appleton & Wistow",501,254,605,398,464,503,632,736,849,834,678,555,571,413,369,7607,7861,8362
E02005811,Barlby & Riccall,543,275,649,518,593,583,601,687,825,791,752,653,662,440,506,8260,8535,9078
E02005812,Sherburn in Elmet & South Milford,518,236,737,824,1019,931,776,768,795,849,691,573,568,364,468,9363,9599,10117
E02005813,Selby Town,649,254,1076,1182,1365,1211,1015,869,877,850,690,473,476,302,467,10853,11107,11756
E02005814,Selby West,300,153,488,404,489,452,421,384,455,531,520,420,477,376,486,5903,6056,6356
E02005815,"Selby South, Brayton & Barlow",397,173,559,507,529,508,510,538,655,686,726,590,612,478,517,7415,7588,7985
E02005816,"Carlton, Hemingbrough & Osgodby",434,189,582,497,548,455,500,622,738,770,632,569,541,372,385,7211,7400,7834
E02005817,"Hambleton, Monk Fryston & Byram",320,163,459,359,446,461,438,482,596,639,562,519,527,350,376,6214,6377,6697
E02005818,"Eggborough, Kellington & Smeaton",414,182,602,456,499,548,500,583,754,729,677,535,533,400,393,7209,7391,7805
E02001509,Royston West,344,162,485,476,513,507,414,423,555,480,493,403,394,285,334,5762,5924,6268
E02001510,Royston East & Carlton,295,146,495,393,426,404,375,366,479,487,397,321,341,231,258,4973,5119,5414
E02001511,Shafton & Upper Cudworth,270,131,417,382,400,352,346,330,485,477,467,446,354,292,351,5099,5230,5500
E02001512,Mapplewell & Staincross,362,166,527,520,604,584,497,531,711,621,531,467,521,359,520,6993,7159,7521
E02001513,Darton & Kexborough,339,169,521,476,476,446,394,519,688,607,477,486,498,395,412,6395,6564,6903
E02001514,Grimethorpe & Brierley,398,173,611,632,684,627,515,464,564,574,491,368,352,242,279,6403,6576,6974
E02001515,Athersley,582,277,786,709,803,744,559,593,745,733,562,521,462,274,327,7818,8095,8677
E02001516,Cudworth Village,338,147,575,490,483,440,399,398,538,425,405,304,257,208,238,5160,5307,5645
E02001517,Monk Bretton,340,159,530,466,533,521,463,486,671,658,633,541,533,409,472,6916,7075,7415
E02001518,Honeywell,476,250,778,781,806,779,711,747,836,785,696,520,520,350,446,8755,9005,9481
E02001519,Lundwood,410,189,593,613,688,633,469,454,581,569,448,368,331,251,297,6295,6484,6894
E02001520,Wilthorpe & Barugh Green,501,253,726,740,709,777,682,731,938,967,822,712,803,625,812,10044,10297,10798
E02001521,Barnsley Town & Park Road,514,232,1120,1296,1476,1230,952,839,883,838,658,488,452,285,322,10839,11071,11585
E02001522,Thurnscoe,473,212,762,702,803,666,527,535,700,699,603,527,453,367,409,7753,7965,8438
E02001523,Ardsley & Stairfoot,238,137,491,544,567,514,454,449,567,534,445,365,334,292,363,5919,6056,6294
E02001524,"Silkstone, Hoylandswaine & Cawthorne",277,132,370,201,244,257,333,428,533,602,525,474,497,433,404,5301,5433,5710
E02001525,Worsbrough Common,293,128,552,651,753,566,446,493,489,497,396,315,246,221,266,5891,6019,6312
E02001526,Kendray,373,166,473,501,556,524,397,372,400,421,356,277,277,216,194,4964,5130,5503
E02001527,Dodworth,244,127,406,328,362,380,347,371,514,499,398,344,411,313,328,5001,5128,5372
E02001528,Darfield & Great Houghton,550,228,820,748,788,665,649,637,846,773,731,687,645,474,536,8999,9227,9777
E02001529,Worsbrough,445,224,746,597,673,583,566,597,797,734,629,551,514,423,587,7997,8221,8666
E02001530,Goldthorpe,397,175,605,580,580,546,471,421,553,518,478,339,254,198,230,5773,5948,6345
E02001531,Wombwell North,280,138,619,643,680,568,471,464,578,540,453,398,407,288,326,6435,6573,6853
E02001532,Penistone,582,228,628,537,668,743,758,780,830,842,673,629,635,426,473,8622,8850,9432
E02001533,Bolton-upon-Dearne,421,179,601,569,581,557,504,496,563,547,513,404,391,243,282,6251,6430,6851
E02001534,Wombwell South,494,221,778,698,752,679,645,645,804,698,574,447,423,274,400,7817,8038,8532
E02001535,"Ingbirchworth, Dunford Bridge & Thurgoland",323,143,396,278,285,318,422,467,593,636,494,458,441,351,378,5517,5660,5983
E02001536,Birdwell,344,180,573,526,545,493,471,574,756,659,587,501,521,452,562,7220,7400,7744
E02001537,Elsecar,358,200,612,509,615,574,547,547,714,706,591,472,411,304,316,6918,7118,7476
E02001538,Hoyland,412,190,582,490,533,525,448,473,641,611,571,503,424,408,394,6603,6793,7205
E02001539,Moorends,402,180,582,482,519,467,406,379,470,463,391,312,287,213,231,5202,5382,5784
E02001540,"Askern, Campsall & Norton",665,330,918,789,811,791,742,761,899,976,838,681,667,472,597,9942,10272,10937
E02001541,Thorne,561,270,831,758,861,750,695,747,937,904,790,692,670,527,700,9862,10132,10693
E02001542,Stainforth,488,199,630,527,606,522,433,454,552,543,497,430,419,268,362,6243,6442,6930
E02001543,Carcroft,444,198,598,507,562,498,483,479,533,612,588,510,466,349,421,6606,6804,7248
E02001544,Hatfield West,502,210,627,514,628,558,518,489,639,636,553,406,443,359,442,6812,7022,7524
E02001545,Kirk Sandall & Barnby Dun,401,174,569,437,440,410,494,563,624,691,569,617,664,448,586,7112,7286,7687
E02001546,Hatfield East,297,141,753,866,900,757,677,556,695,618,539,493,491,389,548,8282,8423,8720
E02001547,Adwick le Street & Woodlands,648,300,928,805,868,771,659,676,746,859,652,524,447,307,428,8670,8970,9618
E02001548,Bentley & Toll Bar,459,189,667,665,745,626,516,497,607,619,460,376,313,244,306,6641,6830,7289
E02001549,Edenthorpe & Mere Lane,316,176,417,353,422,416,368,402,476,486,445,401,349,266,348,5149,5325,5641
E02001550,Scawthorpe,422,182,617,561,598,607,512,464,551,586,545,425,362,243,352,6423,6605,7027
E02001551,Bentley Rise,254,115,445,445,502,388,371,376,414,459,400,324,324,176,236,4860,4975,5229
E02001552,Armthorpe North,408,190,618,531,620,624,495,498,557,537,483,350,352,242,345,6252,6442,6850
E02001553,Wheatley Hills,539,219,787,794,873,890,756,675,700,750,661,508,498,318,450,8660,8879,9418
E02001554,Cusworth,272,148,459,362,398,351,340,375,536,511,428,339,329,289,404,5121,5269,5541
E02001555,Armthorpe South,195,107,301,269,345,278,267,291,355,463,451,466,445,304,367,4602,4709,4904
E02001556,Intake,524,229,799,696,797,822,665,621,708,673,544,415,408,250,352,7750,7979,8503
E02001557,Belle Vue & Town Fields,426,196,874,947,1183,979,826,753,805,756,623,519,405,252,409,9331,9527,9953
E02001558,"Cadeby, Hickleton & Hampole",210,119,366,308,272,306,318,362,480,554,550,461,493,383,448,5301,5420,5630
E02001559,Sprotbrough,341,173,521,435,455,520,452,474,608,648,504,431,455,380,528,6411,6584,6925
E02001560,Central Doncaster & Hyde Park,683,308,1705,1572,1730,1440,1176,964,800,732,560,385,299,206,221,11790,12098,12781
E02001561,Hexthorpe & Balby North,280,129,536,558,603,606,561,425,502,455,419,278,186,157,189,5475,5604,5884
E02001562,Cantley Park,316,120,388,359,402,435,364,384,414,415,401,367,328,243,379,4879,4999,5315
E02001563,Bessacarr Bawtry Road,382,187,485,418,467,551,505,485,560,547,535,537,559,392,648,6689,6876,7258
E02001564,"Old Cantley, Auckley & Finningley",384,187,483,390,397,467,545,525,626,671,625,591,633,443,498,6894,7081,7465
E02001565,Bessacarr Grange & Lakeside,343,157,543,467,500,566,518,491,565,553,552,535,546,398,456,6690,6847,7190
E02001566,Balby Carr,459,199,763,810,996,868,730,606,660,569,465,302,241,172,182,7364,7563,8022
E02001567,Balby South,489,221,694,642,708,711,496,517,601,648,559,497,496,295,425,7289,7510,7999
E02001568,Mexborough East,308,142,494,507,516,476,374,390,473,507,406,363,365,273,271,5415,5557,5865
E02001569,Mexborough West,396,193,689,664,689,612,490,531,681,635,562,456,375,328,357,7069,7262,7658
E02001570,Conisbrough North,344,173,542,476,500,457,382,428,527,512,480,408,414,243,355,5724,5897,6241
E02001571,"Warmsworth, Braithwell & Stainton",256,122,419,331,376,361,334,367,496,486,453,360,381,312,344,5020,5142,5398
E02001572,Edlington,400,165,596,613,703,622,501,478,544,563,515,382,356,229,324,6426,6591,6991
E02001573,Conisbrough South,429,221,624,574,609,610,446,511,568,553,516,393,362,218,381,6365,6586,7015
E02001574,Rossington,307,139,415,305,383,367,352,407,460,469,483,394,437,272,322,5066,5205,5512
E02001575,New Rossington,429,215,675,659,678,581,472,435,518,483,485,335,327,224,341,6213,6428,6857
E02001576,"Bawtry, Austerfield & Hayfield",345,180,457,434,510,499,433,503,520,512,428,351,347,252,323,5569,5749,6094
E02001577,Tickhill & Wadworth,236,110,362,271,290,327,339,379,424,525,517,476,582,504,613,5609,5719,5955
E02001578,Brampton & West Melton,688,302,843,680,874,967,875,821,888,760,655,592,442,300,337,9034,9336,10024
E02001579,Wath upon Dearne,517,248,758,585,663,682,631,645,673,711,658,524,529,392,571,8022,8270,8787
E02001580,Swinton North,373,171,617,550,608,555,485,549,634,624,587,491,543,429,511,7183,7354,7727
E02001581,Swinton South,329,125,420,431,473,448,362,358,432,494,436,395,365,209,271,5094,5219,5548
E02001582,Rawmarsh North West,359,196,589,542,545,514,430,491,603,632,491,420,395,309,380,6341,6537,6896
E02001583,Rawmarsh North East,313,129,435,369,425,421,356,348,384,431,350,297,245,175,217,4453,4582,4895
E02001584,Thorpe Hesley,245,161,440,380,415,367,382,453,558,612,559,515,477,336,361,5855,6016,6261
E02001585,Rawmarsh South,332,145,522,449,481,434,395,424,526,420,376,308,299,224,266,5124,5269,5601
E02001586,Greasborough,292,142,615,554,573,495,422,501,683,678,585,429,453,393,481,6862,7004,7296
E02001587,Thrybergh & Hooton Roberts,263,112,474,441,441,333,332,376,450,463,401,321,313,240,259,4844,4956,5219
E02001588,Kimberworth Park,389,185,549,506,528,545,421,462,560,521,432,353,302,189,351,5719,5904,6293
E02001589,Ravenfield & Bramley North,439,197,525,384,449,475,521,589,699,593,533,467,484,339,376,6434,6631,7070
E02001590,East Herringthorpe,512,236,710,600,602,605,517,470,535,465,390,297,260,186,194,5831,6067,6579
E02001591,Eastwood & East Dene,546,234,865,691,759,699,627,539,575,527,445,365,278,199,272,6841,7075,7621
E02001592,Kimberworth,364,176,660,584,586,533,453,532,623,703,628,516,525,400,427,7170,7346,7710
E02001593,Masbrough & Bradgate,503,240,888,725,700,686,599,542,516,452,393,294,214,134,180,6323,6563,7066
E02001594,Rotherham Central,575,272,1002,872,863,741,647,596,533,449,385,253,214,165,285,7005,7277,7852
E02001595,Maltby West & Hellaby,359,168,604,455,508,503,466,528,720,701,641,523,501,382,467,6999,7167,7526
E02001596,Wickersley North,428,197,557,428,501,514,475,516,608,632,612,554,555,489,626,7067,7264,7692
E02001597,Maltby East,530,211,790,718,770,641,525,543,684,614,602,501,464,309,405,7566,7777,8307
E02001598,Herringthorpe,458,230,674,559,652,594,626,633,746,698,654,540,547,449,651,8023,8253,8711
E02001599,Wickersley South & Bramley South,337,141,501,338,403,417,427,438,582,531,447,408,417,337,428,5674,5815,6152
E02001600,Rotherham South,652,310,1075,787,773,800,833,684,809,736,597,572,565,487,653,9371,9681,10333
E02001601,Whiston,213,104,359,284,289,287,279,329,389,434,358,289,317,241,317,4172,4276,4489
E02001602,Brinsworth,424,182,661,596,662,534,525,541,672,682,586,448,523,449,529,7408,7590,8014
E02001603,Thurcroft,352,164,537,481,599,505,442,436,523,499,477,415,396,260,312,5882,6046,6398
E02001604,"Catcliffe, Treeton & Waverley",548,246,863,896,1036,1040,824,764,827,706,552,422,409,345,333,9017,9263,9811
E02001605,Laughton & Throapham,307,146,578,485,508,469,409,490,622,614,471,444,409,303,391,6193,6339,6646
E02001606,Dinnington,425,209,652,526,579,540,434,489,617,613,520,462,493,385,452,6762,6971,7396
E02001607,Aston,449,188,617,554,670,568,560,541,616,631,577,539,551,413,487,7324,7512,7961
E02001608,Swallownest & Wales,378,157,495,380,453,510,480,475,579,480,425,378,414,327,325,5721,5878,6256
E02001609,Anston & Woodsetts,379,203,594,450,464,446,481,557,686,623,614,546,670,604,551,7286,7489,7868
E02001610,"Kiveton, Todwick & Harthill",421,202,589,433,484,463,496,560,708,667,520,477,546,489,495,6927,7129,7550
E02001611,Stocksbridge,366,186,543,490,470,456,462,531,597,577,501,426,522,411,559,6545,6731,7097
E02001612,Deepcar & Bolsterstone,255,130,416,299,347,331,342,404,501,484,405,330,387,316,286,4848,4978,5233
E02001613,High Green & Burncross,464,240,705,553,614,644,605,579,784,789,748,670,701,516,548,8456,8696,9160
E02001614,Chapeltown,501,281,775,620,620,641,652,831,913,836,774,690,745,600,751,9448,9729,10230
E02001615,Grenoside & Ecclesfield North,254,146,432,389,428,408,386,437,589,619,526,535,584,523,606,6462,6608,6862
E02001616,Ecclesfield South,341,186,554,434,480,473,441,419,565,535,463,344,410,343,461,5922,6108,6449
E02001617,Shiregreen North,423,179,513,465,532,439,367,386,440,362,303,202,148,135,227,4519,4698,5121
E02001618,Oughtibridge & Bradfield,531,264,674,536,565,619,737,784,879,784,731,523,567,450,482,8331,8595,9126
E02001619,Parson Cross,601,328,835,765,810,737,627,592,758,703,564,467,382,302,400,7942,8270,8871
E02001620,Shiregreen South,424,196,579,518,642,505,427,433,473,490,378,279,239,222,229,5414,5610,6034
E02001621,Sheffield Lane Top & Longley Park,371,171,517,458,597,462,378,383,447,388,301,224,203,166,225,4749,4920,5291
E02001622,Southey Green West,470,205,681,638,738,664,558,570,622,631,511,401,354,277,421,7066,7271,7741
E02001623,Firth Park,626,282,901,623,659,636,555,546,548,579,469,355,315,226,354,6766,7048,7674
E02001624,Brightside & Wincobank,483,247,863,798,891,774,672,619,713,676,549,456,384,362,384,8141,8388,8871
E02001625,Southey Green East,490,201,696,598,621,559,507,446,533,534,468,316,316,228,319,6141,6342,6832
E02001626,Wadsley & Marlcliffe,296,141,418,386,425,433,437,403,502,441,405,303,301,226,306,4986,5127,5423
E02001627,"Hillsborough, Owlerton & Wadsley Bridge",264,128,487,581,627,571,421,429,467,417,389,270,244,137,199,5239,5367,5631
E02001628,Tinsley & Carbrook,572,270,776,632,679,625,560,501,417,315,233,219,200,150,212,5519,5789,6361
E02001629,Shirecliffe & Parkwood Springs,415,158,613,540,606,485,467,454,494,457,339,267,234,202,368,5526,5684,6099
E02001630,Crabtree & Fir Vale,802,378,1262,861,913,885,772,679,614,472,374,300,214,180,386,7912,8290,9092
E02001631,Malin Bridge & Wisewood,363,172,547,550,630,608,533,529,636,588,500,356,349,325,413,6564,6736,7099
E02001632,Burngreave & Grimesthorpe,1108,510,1757,1425,1518,1329,1071,914,776,624,419,313,242,162,307,10857,11367,12475
E02001633,Upper Stannington & Loxley,322,145,516,385,440,488,432,476,640,594,600,503,507,435,556,6572,6717,7039
E02001634,Walkley,230,104,636,999,1143,906,725,571,564,607,521,425,393,277,359,8126,8230,8460
E02001635,Lower Stannington,282,122,435,362,443,398,379,366,514,431,389,333,328,322,454,5154,5276,5558
E02001636,"Upperthorpe, Netherthorpe & Langsett",434,201,2774,1560,1142,884,720,625,566,525,433,328,331,246,356,10490,10691,11125
E02001637,Darnall,760,359,1124,819,845,886,705,594,516,376,297,241,164,144,245,6956,7315,8075
E02001638,Springvale & Steel Bank,122,46,2036,799,546,387,297,195,205,174,168,118,147,88,117,5277,5323,5445
E02001639,Crookes,214,72,679,694,597,463,411,374,333,300,259,224,243,184,325,5086,5158,5372
E02001640,Broomhill & Lower Crookesmoor,176,112,3088,911,622,487,370,344,335,287,226,230,198,143,269,7510,7622,7798
E02001642,Littledale & Handsworth North,488,252,913,811,834,749,687,716,791,671,548,436,444,371,502,8473,8725,9213
E02001643,Sandygate & Crosspool,383,163,402,256,290,346,451,540,478,510,427,410,399,325,460,5294,5457,5840
E02001646,Broomhall,196,104,3663,986,589,397,344,327,320,286,280,226,220,140,233,8011,8115,8311
E02001647,Handsworth South,307,151,440,369,442,404,338,394,486,485,393,323,334,310,385,5103,5254,5561
E02001648,Endcliffe & Ranmoor,308,160,4508,674,466,463,462,492,496,487,425,357,345,264,295,9734,9894,10202
E02001649,Woodthorpe,671,304,940,971,1078,938,797,694,757,661,605,431,348,266,243,8729,9033,9704
E02001650,Sharrow,271,119,3295,1534,1082,800,677,518,414,312,252,184,153,102,187,9510,9629,9900
E02001651,Fulwood & Lodge Moor,468,240,497,314,345,473,608,583,676,647,606,530,597,449,590,6915,7155,7623
E02001652,Highfield & Lowfield,394,207,4554,2660,1752,1243,855,538,513,365,299,220,162,119,188,13468,13675,14069
E02001653,Norfolk Park,394,184,881,834,859,750,558,501,445,448,349,246,226,224,235,6556,6740,7134
E02001654,Woodhouse Mill,323,142,477,422,462,410,310,325,507,491,450,275,303,288,499,5219,5361,5684
E02001655,Richmond & Stradbroke,390,190,577,604,624,526,413,481,564,564,447,370,403,280,342,6195,6385,6775
E02001656,Brincliffe & Sharrow Vale,339,178,1013,853,712,658,609,517,550,472,400,324,291,192,269,6860,7038,7377
E02001657,Ecclesall & Greystones,494,210,605,584,590,751,793,738,640,636,515,446,424,282,380,7384,7594,8088
E02001658,Arbourthorne,331,147,479,430,491,371,356,354,417,373,285,236,178,158,169,4297,4444,4775
E02001659,Woodhouse West,242,112,480,431,400,371,356,404,464,496,411,335,293,195,320,4956,5068,5310
E02001660,Nether Edge,458,214,795,960,1083,1010,854,701,648,618,546,489,429,267,400,8800,9014,9472
E02001661,Heeley & Newfield Green,366,178,625,627,811,728,563,483,580,510,405,317,307,232,348,6536,6714,7080
E02001662,Intake,317,163,512,552,537,458,383,429,606,539,517,418,408,344,564,6267,6430,6747
E02001663,Meersbrook,325,127,459,541,757,784,710,620,616,568,400,337,237,155,255,6439,6566,6891
E02001664,Gleadless,285,141,445,403,483,420,316,390,456,453,443,374,391,292,431,5297,5438,5723
E02001665,Bents Green & Millhouses,553,277,621,390,387,600,740,713,812,797,701,624,682,499,711,8277,8554,9107
E02001666,Beighton,302,140,486,441,447,392,361,373,459,485,416,267,273,219,226,4845,4985,5287
E02001669,Woodseats,302,148,531,628,678,665,594,517,572,577,443,333,302,244,369,6453,6601,6903
E02001670,Herdings & Gleadless Valley,384,148,525,442,490,440,380,374,470,393,327,238,215,191,264,4749,4897,5281
E02001671,Hackenthorpe,195,88,389,362,316,300,291,335,452,495,526,426,422,368,412,5094,5182,5377
E02001672,Charnock & Basegreen,264,138,461,365,453,357,357,367,463,473,388,326,319,274,417,5020,5158,5422
E02001673,Sothall,245,101,394,368,372,296,310,362,432,489,435,327,274,178,209,4446,4547,4792
E02001674,Norton & Norton Lees,383,172,514,473,593,608,571,559,690,734,675,599,602,514,719,7851,8023,8406
E02001675,Westfield & Waterthorpe,342,159,576,535,524,507,478,530,642,645,623,589,615,474,515,7253,7412,7754
E02001676,Beauchief,275,138,404,271,285,302,416,391,506,517,422,419,390,300,451,5074,5212,5487
E02001678,Dore & Whirlow,517,255,648,379,419,636,730,667,763,828,737,669,722,645,916,8759,9014,9531
E02001679,Greenhill & Lowedges,309,139,487,472,522,442,398,408,430,418,340,303,306,248,317,5091,5230,5539
E02001680,Batemoor & Jordanthorpe,308,155,570,516,549,468,418,391,471,408,355,243,248,189,300,5126,5281,5589
E02001681,Totley & Bradway,380,184,444,307,394,488,539,526,572,610,483,454,528,410,544,6299,6483,6863
E02006803,Mosborough & Halfway,397,206,665,602,531,570,577,622,807,762,609,512,520,393,470,7640,7846,8243
E02006843,Cathedral & Kelham,124,102,9428,6275,2216,1014,492,273,153,145,91,68,38,17,19,20229,20331,20455
E02006844,Devonshire Quarter,174,89,4885,2977,1418,685,471,304,228,182,134,91,72,36,73,11556,11645,11819
E02006868,Park Hill & Wybourn,521,254,1821,1676,1448,1110,907,741,870,759,594,456,401,300,408,11491,11745,12266
E02006869,Birley,525,257,934,810,811,714,637,745,950,878,674,507,530,427,582,9199,9456,9981
E02002183,Addingham & Ilkley Moor,223,116,307,195,196,232,288,354,440,554,470,437,529,441,632,5075,5191,5414
E02002184,Ilkley & Ben Rhydding,727,349,798,579,578,637,853,955,1093,1019,916,801,859,703,1405,11196,11545,12272
E02002185,Burley-in-Wharfedale,283,134,331,260,334,370,415,467,474,448,388,338,380,262,391,4858,4992,5275
E02002186,Steeton & Silsden,542,240,785,858,950,859,870,867,949,1095,1012,882,919,665,921,11632,11872,12414
E02002187,Menston & Burley Moor,351,155,383,247,322,379,416,490,465,499,469,419,392,314,431,5226,5381,5732
E02002188,Riddlesden & East Morton,395,197,585,389,445,535,488,519,615,621,556,455,495,287,394,6384,6581,6976
E02002189,Keighley Utley,550,242,762,491,523,568,568,473,392,345,385,372,295,202,365,5741,5983,6533
E02002190,Keighley Central & East,822,391,1318,996,1061,1090,965,804,720,637,588,585,390,250,380,9784,10175,10997
E02002191,Keighley Oakworth Road & West Lane,726,358,995,763,868,857,712,658,615,555,460,357,292,211,268,7611,7969,8695
E02002192,Crossflatts & Eldwick,401,197,546,385,523,536,638,619,641,790,735,714,676,509,694,8006,8203,8604
E02002193,Keighley South,339,140,518,519,524,513,394,390,443,450,392,303,311,225,219,5201,5341,5680
E02002194,Keighley Exley Head,366,179,609,509,552,496,426,458,540,618,531,384,445,275,408,6251,6430,6796
E02002195,Baildon North,278,160,336,259,330,331,413,469,523,553,549,443,538,358,440,5542,5702,5980
E02002196,Oakworth & Laycock,322,154,502,361,414,415,388,445,516,554,465,343,364,210,249,5226,5380,5702
E02002197,Bingley Town,419,205,585,577,708,644,666,659,693,621,528,440,485,335,559,7500,7705,8124
E02002198,Baildon South,337,163,553,427,600,585,534,572,612,637,579,494,542,357,501,6993,7156,7493
E02002199,Thackley & Esholt,293,132,466,406,574,497,490,518,576,620,554,440,377,278,358,6154,6286,6579
E02002200,Saltaire & Baildon West,450,213,525,475,648,675,683,666,650,667,574,510,529,400,566,7568,7781,8231
E02002201,Idle,581,303,872,795,952,939,843,829,901,948,848,656,592,380,480,10035,10338,10919
E02002202,Shipley Town,323,158,515,634,712,659,634,541,534,525,434,315,316,210,328,6357,6515,6838
E02002203,Windhill,393,201,619,583,611,602,551,495,589,547,430,406,357,207,254,6251,6452,6845
E02002204,"Cottingley, Harden & Wilsden",548,273,723,613,672,714,784,741,844,971,852,751,821,541,732,9759,10032,10580
E02002205,Haworth & Oxenhope,382,201,598,512,567,541,612,658,883,923,833,685,689,422,475,8398,8599,8981
E02002206,Wrose & Bolton Woods,470,224,715,607,698,652,502,513,596,635,579,446,400,292,401,7036,7260,7730
E02002207,Frizinghall & Heaton Grove,563,269,872,620,681,726,638,549,495,419,349,280,243,137,244,6253,6522,7085
E02002208,Eccleshill,490,223,681,603,658,649,531,497,525,575,533,352,350,274,382,6610,6833,7323
E02002209,Ravenscliffe,553,237,696,498,663,668,511,446,430,413,331,237,192,120,125,5330,5567,6120
E02002210,Bolton Road & Kings Road,502,225,721,609,602,584,556,494,543,491,432,370,317,197,377,6293,6518,7020
E02002211,Heaton Highgate,541,304,922,645,661,670,639,532,477,350,342,302,236,139,240,6155,6459,7000
E02002212,Chellow Heights,766,394,1084,693,755,790,819,666,513,330,313,216,152,97,214,6642,7036,7802
E02002213,Cullingworth & Denholme,360,176,498,426,498,492,486,508,618,629,480,500,458,329,334,6256,6432,6792
E02002214,Haigh Fold,377,191,568,450,539,542,437,430,397,393,341,292,242,146,220,4997,5188,5565
E02002215,Toller Lane & Infirmary,761,388,1453,953,958,1010,896,723,600,416,491,432,220,128,248,8528,8916,9677
E02002216,Manningham & Lister Park,727,330,1278,964,1005,989,872,735,635,435,379,374,253,131,277,8327,8657,9384
E02002217,Undercliffe,872,410,1300,818,873,860,846,671,645,436,391,322,238,149,270,7819,8229,9101
E02002218,Allerton,687,339,875,664,802,832,751,655,642,600,546,374,416,229,353,7739,8078,8765
E02002219,Girlington,784,331,1157,741,784,805,802,630,490,313,255,241,139,83,149,6589,6920,7704
E02002220,Thornbury,840,395,1266,901,794,846,840,651,627,414,343,324,197,86,166,7455,7850,8690
E02002221,Central Bradford & Barkerend West,1043,512,2311,2066,2197,2115,1578,1120,839,589,465,365,212,116,233,14206,14718,15761
E02002222,Fairweather Green,710,297,885,571,711,787,727,614,544,433,400,333,275,194,354,6828,7125,7835
E02002223,Brown Royd,715,342,1200,780,852,826,755,566,466,327,299,248,160,85,134,6698,7040,7755
E02002224,Barkerend East,962,458,1458,1010,999,1017,986,779,641,459,358,295,189,109,245,8545,9003,9965
E02002225,Thornton,468,221,612,459,574,645,553,620,683,693,548,502,490,285,379,7043,7264,7732
E02002226,Shearbridge & University,1064,516,3424,2596,2201,1993,1552,986,757,475,435,365,224,118,298,15424,15940,17004
E02002227,Broomfields & East Bowling,490,223,799,584,601,631,565,477,433,353,299,208,137,104,116,5307,5530,6020
E02002228,Laisterdyke & Bowling,554,208,723,574,713,660,553,439,488,441,398,291,241,152,199,5872,6080,6634
E02002229,Clayton,585,266,727,508,536,495,519,495,624,612,514,434,384,258,346,6452,6718,7303
E02002230,Holme Top,709,277,1169,826,976,981,880,652,540,397,346,260,157,84,147,7415,7692,8401
E02002231,Scholemoor,927,447,1350,930,1016,1127,1040,954,896,703,658,578,452,260,412,10376,10823,11750
E02002232,Great Horton & Brackenhill,569,262,825,612,646,656,628,516,438,346,352,267,213,107,207,5813,6075,6644
E02002233,Canterbury,960,427,1300,782,815,941,871,634,545,408,347,268,184,108,148,7351,7778,8738
E02002234,Holme Wood,677,261,713,597,713,703,560,431,485,491,431,275,229,151,194,5973,6234,6911
E02002235,Bowling Park,607,288,880,566,628,680,668,510,428,327,339,246,172,110,166,5720,6008,6615
E02002236,Wibsey St Enoch's,380,174,555,440,461,518,406,415,433,393,383,313,260,183,291,5051,5225,5605
E02002237,Horton Bank,565,252,785,644,693,725,612,504,544,562,463,359,311,196,320,6718,6970,7535
E02002238,Bankfoot,486,213,618,402,490,511,481,400,469,402,383,284,259,157,212,5068,5281,5767
E02002239,Bierley & Tong,687,318,929,692,878,946,829,699,830,797,609,472,409,248,300,8638,8956,9643
E02002240,Queensbury,577,266,852,712,840,814,756,786,926,955,792,619,579,362,446,9439,9705,10282
E02002241,Buttershaw,788,321,964,888,977,977,907,802,867,805,726,575,510,323,461,9782,10103,10891
E02002242,Low Moor,347,171,590,483,540,543,466,479,612,609,574,503,496,347,446,6688,6859,7206
E02002243,Wyke,497,235,712,631,770,697,606,616,739,718,616,516,527,362,413,7923,8158,8655
E02002244,Illingworth & Ogden,310,155,446,419,403,376,349,416,537,505,396,364,385,291,311,5198,5353,5663
E02002245,Mixenden,386,166,498,419,448,405,343,355,411,408,294,215,239,149,143,4327,4493,4879
E02002246,Northowram & Shelf,436,214,629,554,584,597,544,651,777,810,742,635,649,478,577,8227,8441,8877
E02002247,Hebden Bridge,440,220,483,424,465,557,666,735,962,957,757,633,594,343,332,7908,8128,8568
E02002248,Wheatley & Ovenden West,464,215,703,596,609,582,554,496,611,604,492,367,380,251,270,6515,6730,7194
E02002249,Ovenden East,342,167,533,455,526,448,364,372,431,370,330,234,245,154,196,4658,4825,5167
E02002250,Mytholmroyd & Cragg Vale,432,183,578,443,492,478,513,650,769,750,708,553,551,394,426,7305,7488,7920
E02002251,Central Halifax & Boothtown,326,152,605,696,963,873,663,590,654,640,540,419,372,272,409,7696,7848,8174
E02002252,Norton Tower & Mount Tabor,342,140,441,396,452,516,424,416,485,501,403,360,376,274,359,5403,5543,5885
E02002253,Pellon West & Highroad Well,643,328,911,689,714,789,701,580,492,431,357,258,201,152,202,6477,6805,7448
E02002254,Hipperholme,324,171,437,301,364,414,382,436,487,539,431,376,385,288,377,5217,5388,5712
E02002255,Pellon East,640,319,1048,803,773,823,764,606,533,338,308,277,191,157,349,6970,7289,7929
E02002256,Todmorden West & Cornholme,501,248,623,549,635,643,640,680,784,778,612,546,545,382,399,7816,8064,8565
E02002257,King Cross,541,231,813,641,616,610,575,448,402,286,293,230,127,96,117,5254,5485,6026
E02002258,Clifton & Bailiff Bridge,425,201,596,527,571,543,554,620,721,701,584,505,514,359,425,7220,7421,7846
E02002259,Savile Park,365,168,520,471,566,590,510,508,471,474,448,362,360,252,442,5974,6142,6507
E02002260,Sowerby Bridge,400,196,653,641,652,653,589,627,725,680,606,484,546,349,351,7556,7752,8152
E02002261,Southowram & Siddal,395,203,596,529,648,573,519,514,571,670,601,443,429,300,345,6738,6941,7336
E02002262,Brighouse,343,171,591,458,483,457,438,497,616,703,541,414,490,342,538,6568,6739,7082
E02002263,Sowerby & Luddendenfoot,354,164,489,333,407,441,443,479,571,546,488,400,385,258,237,5477,5641,5995
E02002264,Skircoat Green,365,165,447,353,402,490,436,519,578,537,472,382,445,339,496,5896,6061,6426
E02002265,Todmorden East & Walsden,255,126,370,296,382,364,389,367,523,432,384,360,370,238,286,4761,4887,5142
E02002266,Rastrick East,246,120,379,361,365,346,357,423,481,437,369,346,374,329,343,4910,5030,5276
E02002267,Rastrick West,412,191,571,513,520,465,464,550,688,603,536,462,507,372,381,6632,6823,7235
E02002268,Elland,543,273,778,665,746,695,645,702,802,794,622,502,539,395,544,8429,8702,9245
E02002269,Greetland & Stainland,478,236,651,473,621,582,629,699,839,717,663,577,568,386,394,7799,8035,8513
E02002270,"Ripponden, Rishworth & Barkisland",461,240,597,419,441,500,603,656,791,791,640,528,477,379,322,7144,7384,7845
E02002271,Birkenshaw,362,168,480,427,491,520,513,480,561,553,470,389,451,329,448,6112,6280,6642
E02002272,Birstall,482,231,676,635,764,721,616,621,715,733,608,462,516,354,438,7859,8090,8572
E02002273,Scholes & Hunsworth,249,147,436,385,436,412,373,415,538,532,423,364,380,264,324,5282,5429,5678
E02002274,Gomersal,370,169,472,354,426,438,437,471,561,546,452,379,367,280,347,5530,5699,6069
E02002275,Cleckheaton,404,178,666,584,711,606,605,630,680,649,499,447,480,324,519,7400,7578,7982
E02002276,"Wilton Park, Carlinghow & Brookroyd",460,198,599,504,537,548,515,458,575,529,414,378,387,306,281,6031,6229,6689
E02002277,Upper Batley & Soothill,405,203,664,463,522,535,533,452,492,414,317,246,271,219,293,5421,5624,6029
E02002278,Hightown & Hartshead Moor,387,166,544,434,424,484,435,415,540,429,408,341,390,278,250,5372,5538,5925
E02002279,"Liversedge, Littletown & Millbridge",356,160,499,437,451,434,406,444,489,486,358,338,314,219,268,5143,5303,5659
E02002280,Batley Central,435,225,751,505,564,602,507,436,396,310,298,300,219,146,167,5201,5426,5861
E02002281,Heckmondwike North,686,322,973,831,892,911,859,762,775,665,613,521,513,344,476,9135,9457,10143
E02002282,Staincliffe & Healey,517,244,814,588,584,667,572,487,527,375,325,257,215,151,175,5737,5981,6498
E02002283,Batley Carr & Mount Pleasant,421,230,850,614,595,643,565,532,531,377,388,373,241,130,172,6011,6241,6662
E02002284,Shaw Cross & Hanging Heaton,272,138,443,408,466,395,403,379,453,461,389,333,306,237,307,4980,5118,5390
E02002285,"Heckmondwike Town, Norristhorpe & Roberttown",387,197,586,463,471,527,523,532,652,626,514,477,498,350,438,6657,6854,7241
E02002286,Dewsbury Moor Upper,403,201,572,496,552,538,482,430,422,361,315,272,223,115,169,4947,5148,5551
E02002287,Dewsbury Central & Westborough,435,201,785,600,697,613,612,545,498,400,330,267,190,154,249,5940,6141,6576
E02002288,Earlsheaton & Chickenley,570,282,766,706,839,786,689,657,741,694,567,407,430,270,404,7956,8238,8808
E02002289,Dewsbury Moor Lower & Westtown,569,270,859,610,667,580,564,525,455,292,244,177,165,102,153,5393,5663,6232
E02002290,Northorpe & Crossley,354,132,399,300,353,378,395,427,456,459,444,387,452,371,424,5245,5377,5731
E02002291,Battyeford,325,172,451,382,445,428,439,454,489,463,401,359,395,345,336,5387,5559,5884
E02002292,Bradley & North Fixby,282,131,411,289,338,337,361,347,416,440,432,377,330,242,327,4647,4778,5060
E02002293,Ravensthorpe,739,355,1162,737,829,885,812,646,552,378,285,227,187,115,138,6953,7308,8047
E02002294,Dewsbury Savile Town & Thornhill Lees,765,407,1409,916,868,868,868,818,696,519,507,468,296,209,274,8716,9123,9888
E02002295,Deighton & Brackenhall,487,219,625,550,621,627,552,474,540,481,322,277,211,176,211,5667,5886,6373
E02002296,Mirfield Central & Hopton,274,140,494,409,410,430,386,414,595,557,414,381,473,380,537,5880,6020,6294
E02002297,Cowcliffe & South Fixby,366,184,555,428,441,492,542,520,549,465,484,417,430,281,336,5940,6124,6490
E02002298,Thornhill,320,152,528,423,502,408,348,417,495,570,462,391,395,258,366,5563,5715,6035
E02002299,Huddersfield Leeds Road & Fartown,437,178,1410,1038,835,768,611,502,462,407,315,215,168,118,221,7070,7248,7685
E02002300,North Lindley & Birchencliffe,433,183,498,474,667,635,634,583,573,557,507,428,418,351,540,6865,7048,7481
E02002301,Birkby,606,254,923,802,874,864,693,644,536,407,341,283,169,110,230,6876,7130,7736
E02002302,Kirkheaton,369,141,388,307,354,333,405,485,510,511,446,340,402,274,334,5089,5230,5599
E02002303,Oakes & South Lindley,328,149,493,418,507,474,482,445,503,473,374,315,299,237,393,5413,5562,5890
E02002304,Edgerton & Marsh,261,119,989,881,661,625,511,435,467,430,369,272,261,199,240,6340,6459,6720
E02002305,Rawthorpe,350,148,602,509,495,456,397,380,431,412,356,263,218,144,232,4895,5043,5393
E02002306,"Scapegoat Hill, Outlane & West Golcar",283,132,411,310,370,379,371,420,548,518,543,403,362,263,334,5232,5364,5647
E02002307,Dalton Long Lane,284,146,423,405,416,365,305,368,470,485,425,301,313,241,283,4800,4946,5230
E02002308,Longwood & Quarmby,309,142,498,459,523,467,426,501,533,498,368,333,301,247,266,5420,5562,5871
E02002309,Paddock & Greenhead,379,199,841,707,615,671,505,477,474,402,335,254,227,179,237,5924,6123,6502
E02002310,Moldgreen & Ravensknowle Park,275,115,530,499,478,415,388,342,427,411,307,257,269,217,294,4834,4949,5224
E02002311,Golcar,298,172,438,470,476,408,406,404,525,472,423,355,370,222,289,5258,5430,5728
E02002312,"Aspley, Longley & University",312,174,3284,2256,1002,727,452,474,425,393,325,271,199,150,190,10148,10322,10634
E02002313,Lockwood,568,272,976,845,770,824,716,621,506,389,320,258,146,130,208,6709,6981,7549
E02002314,Almondbury & Waterloo,280,136,419,350,364,319,327,335,463,437,369,358,387,309,416,4853,4989,5269
E02002315,Cowlersley & Milnsbridge,324,153,503,462,584,448,433,425,530,473,438,296,270,165,205,5232,5385,5709
E02002316,"Lepton, Grange Moor & Flockton",271,158,441,384,357,365,443,397,580,494,510,373,487,307,403,5541,5699,5970
E02002317,Crosland Moor,484,210,649,505,612,560,502,487,511,455,401,328,280,199,295,5784,5994,6478
E02002318,"Primrose Hill, Newsome & Berry Brow",257,114,567,487,500,421,363,381,474,477,403,321,406,273,355,5428,5542,5799
E02002319,Slaithwaite & Linthwaite,332,175,412,445,522,511,509,516,560,540,405,345,353,233,284,5635,5810,6142
E02002320,Netherton & South Crosland,229,112,360,321,387,376,387,394,470,498,437,431,448,322,433,5264,5376,5605
E02002321,Kirkburton & Farnley Tyas,313,161,1161,414,345,369,385,463,486,516,443,431,451,321,346,6131,6292,6605
E02002322,Marsden & Pole Moor,311,128,362,299,339,454,437,453,522,567,495,409,439,273,299,5348,5476,5787
E02002323,Honley & Brockholes,430,207,551,380,429,490,492,547,677,672,565,508,601,423,497,6832,7039,7469
E02002324,Emley & Skelmanthorpe,327,133,442,333,347,356,390,443,587,485,427,430,517,394,376,5527,5660,5987
E02002325,Meltham,444,212,629,572,564,568,506,615,744,696,612,500,582,411,509,7508,7720,8164
E02002326,Shelley & Shepley,329,175,418,269,325,344,375,487,511,499,426,344,394,310,274,4976,5151,5480
E02002327,"Denby Dale, Cumberworth & Clayton West",496,238,661,474,484,565,623,755,840,821,696,616,667,501,628,8331,8569,9065
E02002328,Upperthong & Holmbridge,349,167,465,318,386,381,407,520,693,630,523,478,480,339,413,6033,6200,6549
E02002329,"Holmfirth, New Mill & Hepworth",651,344,873,627,683,670,781,920,1115,1107,920,766,848,560,459,10329,10673,11324
E02002330,Wetherby West,285,152,441,311,407,383,456,440,458,565,552,507,579,504,517,6120,6272,6557
E02002331,Wetherby East & Thorp Arch,250,244,590,578,655,582,544,487,520,507,442,389,465,422,739,6920,7164,7414
E02002332,Otley North,335,153,456,307,406,445,430,398,517,528,402,412,447,337,380,5465,5618,5953
E02002333,Otley South,337,168,446,378,440,522,560,520,607,624,586,541,576,415,553,6768,6936,7273
E02002334,Boston Spa & Bramham,367,171,437,293,358,485,509,565,574,525,500,476,537,499,550,6308,6479,6846
E02002335,"Collingham, Rigton & Harewood",350,175,467,296,370,455,517,513,593,621,568,506,565,461,545,6477,6652,7002
E02002336,Bramhope & Pool-in-Wharfedale,370,169,437,288,327,412,435,532,546,581,528,387,482,341,484,5780,5949,6319
E02002337,Guiseley North & West,404,167,450,387,443,484,612,582,577,617,491,419,483,326,431,6302,6469,6873
E02002338,Guiseley East & South,438,183,469,394,465,474,532,574,535,472,370,370,433,330,457,5875,6058,6496
E02002339,Yeadon West,264,118,391,356,460,410,408,363,432,409,348,300,314,212,305,4708,4826,5090
E02002340,Yeadon East,220,122,352,357,432,375,325,397,458,441,388,390,412,317,393,5037,5159,5379
E02002341,Alwoodley,404,161,432,349,367,535,576,586,526,522,495,466,489,374,539,6256,6417,6821
E02002342,Cookridge & Holt Park,276,108,329,365,450,501,413,405,415,425,382,364,367,270,420,5106,5214,5490
E02002343,Yeadon South,298,132,363,365,456,418,467,451,451,436,380,329,314,235,264,4929,5061,5359
E02002344,Primley Park & Wigton Moor,369,168,456,481,521,667,724,588,490,551,528,405,497,325,551,6784,6952,7321
E02002345,Adel,308,125,377,320,384,438,505,384,440,403,439,377,407,252,392,5118,5243,5551
E02002346,Tinshill,321,142,460,405,572,525,468,399,452,404,332,316,297,189,296,5115,5257,5578
E02002347,Moor Allerton,390,156,490,391,499,547,580,478,464,392,361,280,263,179,261,5185,5341,5731
E02002348,Lawnswood & Ireland Wood,332,150,439,459,603,509,473,416,468,415,411,361,343,233,403,5533,5683,6015
E02002349,Roundhay Park & Slaid Hill,247,130,337,447,509,528,557,432,455,344,343,321,322,224,319,5138,5268,5515
E02002350,Horsforth West,311,141,605,336,297,402,530,452,392,426,307,272,367,321,490,5197,5338,5649
E02002351,"Scarcroft, Shadwell & Scholes",252,113,315,270,324,330,386,377,460,444,436,351,406,297,394,4790,4903,5155
E02002352,Moortown,364,184,499,512,642,712,709,564,571,536,443,423,391,287,377,6666,6850,7214
E02002353,Roundhay West,321,148,424,399,450,555,563,495,469,435,376,335,266,156,205,5128,5276,5597
E02002354,Carr Manor,429,213,501,550,684,809,734,604,591,522,486,404,343,265,440,6933,7146,7575
E02002356,Horsforth South & Rawdon,451,248,542,609,718,791,733,693,634,564,453,417,462,321,390,7327,7575,8026
E02002357,Horsforth East,405,167,536,692,741,733,649,570,512,502,415,365,373,269,396,6753,6920,7325
E02002358,Whinmoor,422,159,651,615,733,670,605,498,572,582,476,486,459,274,383,7004,7163,7585
E02002359,"Aberford, Barwick & Thorner",312,143,418,312,372,401,458,508,553,570,463,402,434,379,462,5732,5875,6187
E02002360,Meanwood,331,122,553,592,631,614,594,489,464,448,434,284,247,197,283,5830,5952,6283
E02002361,Gledhow,394,171,389,411,458,515,586,466,480,429,325,260,233,129,235,4916,5087,5481
E02002362,Hawksworth & West Park,434,189,642,705,737,798,616,567,569,533,466,333,300,198,249,6713,6902,7336
E02002363,Chapel Allerton North,228,102,451,902,962,746,611,496,446,505,404,329,295,199,316,6662,6764,6992
E02002364,Seacroft North & Monkswood,321,140,524,406,473,516,405,416,462,421,366,301,286,162,316,5054,5194,5515
E02002366,Lady Wood & Oakwood,513,257,808,608,652,675,717,631,540,499,408,356,364,297,499,7054,7311,7824
E02002367,Meanwood South & Sugarwell,421,204,609,570,680,708,573,497,461,441,349,208,204,136,218,5654,5858,6279
E02002368,Calverley & Farsley North,392,155,439,495,634,736,705,629,652,594,464,408,473,322,439,6990,7145,7537
E02002369,Hollin Park & Fearnville,501,243,701,623,755,660,608,548,579,532,421,308,255,196,246,6432,6675,7176
E02002370,Swarcliffe,454,176,561,604,634,602,459,408,498,444,370,269,295,201,260,5605,5781,6235
E02002371,Chapel Allerton South & Chapeltown,684,312,1235,1100,1246,1125,947,845,823,757,558,429,254,185,400,9904,10216,10900
E02002373,Headingley,78,40,3690,1530,686,442,310,240,179,146,130,135,115,86,116,7805,7845,7923
E02002374,Kirkstall,286,106,944,1125,1019,844,529,427,334,356,322,285,232,159,199,6775,6881,7167
E02002375,Bramley Fall,405,168,933,615,662,620,487,362,433,412,275,263,196,103,133,5494,5662,6067
E02002376,Gipton North,648,315,998,611,704,763,720,609,541,449,355,208,168,122,198,6446,6761,7409
E02002377,Harehills North,688,356,1352,1019,1114,1016,921,720,540,372,264,226,155,75,140,7914,8270,8958
E02002379,Seacroft South,436,185,623,555,577,495,446,349,400,358,306,183,180,101,132,4705,4890,5326
E02002380,Bramley Park North,238,103,410,404,462,460,389,339,408,419,350,335,298,187,263,4724,4827,5065
E02002381,Rodley & Stanningley Park,246,110,404,537,589,549,458,443,477,406,371,303,294,161,207,5199,5309,5555
E02002382,Harehills South,785,359,1327,982,1066,966,842,721,515,368,233,156,91,63,123,7453,7812,8597
E02002383,Hyde Park,116,43,4187,888,560,438,309,208,157,96,91,71,60,29,40,7134,7177,7293
E02002384,Woodhouse & Little London,541,214,6047,3664,2228,1706,1087,704,486,405,333,241,186,124,156,17367,17581,18122
E02002385,Burley,208,102,2510,1924,1339,932,609,405,334,227,208,156,138,81,127,8990,9092,9300
E02002386,Cross Gates East & Manston,354,151,541,528,640,622,583,552,648,683,653,576,628,497,706,7857,8008,8362
E02002387,Bramley Park South,335,162,581,539,587,521,440,417,455,397,302,228,216,156,197,5036,5198,5533
E02002388,Bramley East,457,197,663,753,835,809,673,542,500,533,368,261,264,153,259,6613,6810,7267
E02002389,Gipton South & Killingbeck Park,587,257,718,482,606,638,591,584,507,451,382,292,280,162,268,5961,6218,6805
E02002390,Cross Gates West & Killingbeck,323,194,521,558,633,543,472,467,546,521,410,319,291,191,245,5717,5911,6234
E02002391,"Farsley South, Stanningley & Pudsey North West",323,159,474,537,712,658,590,591,614,579,444,387,394,237,318,6535,6694,7017
E02002392,University & Little Woodhouse,156,116,8778,3743,1335,855,470,282,229,181,141,97,65,34,55,16265,16381,16537
E02002393,Lincoln Green & St James,585,248,1048,1120,1276,1160,924,800,589,474,352,228,156,101,151,8379,8627,9212
E02002394,Burmantofts,575,275,853,781,846,814,729,667,576,464,302,206,178,131,137,6684,6959,7534
E02002395,New Pudsey,434,194,571,520,624,614,578,474,469,406,378,344,294,213,355,5840,6034,6468
E02002396,Bramley South & Upper Armley,372,208,743,946,982,781,617,593,630,632,523,395,368,242,385,7837,8045,8417
E02002397,Pudsey North East,366,177,597,555,606,567,504,524,584,546,468,385,382,250,334,6302,6479,6845
E02002398,Temple Newsam & Graveleythorpe,314,175,532,460,525,510,409,503,587,583,524,454,444,365,575,6471,6646,6960
E02002399,Osmondthorpe & Neville Hill,416,192,555,548,640,547,480,412,449,437,350,271,231,128,176,5224,5416,5832
E02002400,Armley & New Wortley,485,202,1054,1308,1409,1210,875,728,600,489,396,264,207,158,207,8905,9107,9592
E02002401,Halton Moor,512,210,666,542,608,525,485,465,437,398,348,234,238,140,190,5276,5486,5998
E02002402,"Colton, Austhorpe & Whitkirk",231,99,416,372,414,370,397,377,489,528,511,323,334,250,383,5164,5263,5494
E02002403,Garforth West,258,135,520,389,426,379,396,430,478,414,383,299,418,342,568,5442,5577,5835
E02002404,East End Park & Richmond Hill,443,215,1419,1674,1533,1100,772,570,561,440,368,311,220,146,168,9282,9497,9940
E02002405,Pudsey South West,465,231,647,562,656,684,644,590,648,624,549,432,398,359,525,7318,7549,8014
E02002406,Garforth East,355,157,481,404,498,475,495,531,546,511,463,396,543,440,416,6199,6356,6711
E02002407,Farnley East,429,185,552,576,641,611,509,417,421,421,319,238,180,149,205,5239,5424,5853
E02002408,Pudsey South East,346,170,529,476,599,583,537,554,591,551,461,407,394,291,416,6389,6559,6905
E02002409,Farnley West & Gamble Hill,332,157,461,440,536,463,434,432,479,481,415,304,290,195,274,5204,5361,5693
E02002410,Wortley,260,130,537,540,619,624,476,445,525,530,425,343,316,233,299,5912,6042,6302
E02002411,Holbeck,443,196,1189,1390,1229,1056,818,629,511,440,316,212,169,92,181,8232,8428,8871
E02002412,New Farnley & Lower Wortley,373,168,547,612,701,570,570,511,537,506,416,323,316,205,274,6088,6256,6629
E02002414,Beeston Hill & Hunslet Moor,470,210,701,646,725,733,622,570,453,405,318,215,165,127,175,5855,6065,6535
E02002415,Cross Flats Park & Garnets,608,319,1169,853,979,994,939,845,628,446,289,211,98,56,77,7584,7903,8511
E02002416,"Garforth South, Swillington & Little Preston",353,156,458,413,477,452,405,416,501,540,437,384,457,430,508,5878,6034,6387
E02002417,"Kippax East, Micklefield & Allerton Bywater",363,159,464,488,553,555,472,437,482,481,421,385,420,328,388,5874,6033,6396
E02002418,Kippax West,368,139,495,502,471,436,479,505,560,537,504,385,400,288,319,5881,6020,6388
E02002419,Beeston West & Cottingley,452,219,667,687,806,796,746,575,532,531,438,362,297,196,268,6901,7120,7572
E02002420,Beeston East,558,218,769,817,832,835,759,649,544,582,436,309,302,221,300,7355,7573,8131
E02002421,Belle Isle North,404,188,599,490,589,530,495,413,470,428,337,241,212,112,197,5113,5301,5705
E02002422,Churwell,260,111,375,456,488,506,466,410,478,441,431,329,384,267,335,5366,5477,5737
E02002423,Belle Isle South,338,169,492,403,491,512,392,346,456,399,352,296,264,173,223,4799,4968,5306
E02002424,Morley North & Gildersome East,362,168,530,531,544,559,561,544,592,605,476,358,389,283,343,6315,6483,6845
E02002425,Drighlington & Gildersome West,416,166,549,496,576,583,560,632,681,609,600,488,564,397,518,7253,7419,7835
E02002426,Woodlesford & Oulton,364,170,561,528,533,567,505,536,639,608,469,390,408,333,508,6585,6755,7119
E02002427,Rothwell Inner,277,144,451,415,509,488,442,408,508,526,465,359,404,324,409,5708,5852,6129
E02002428,Middleton Town Street,410,202,586,603,687,797,597,513,662,502,437,347,302,203,258,6494,6696,7106
E02002429,Rothwell Outer,444,189,562,521,627,637,620,648,682,612,488,417,422,376,398,7010,7199,7643
E02002430,Middleton Park Avenue,560,247,770,668,736,712,605,524,540,528,392,237,232,168,223,6335,6582,7142
E02002431,Morley East,448,198,640,752,861,767,698,676,633,630,433,355,346,212,219,7222,7420,7868
E02002432,Methley,407,199,549,446,505,499,508,577,628,579,454,339,400,347,395,6226,6425,6832
E02002433,Morley Central,247,116,460,577,599,537,435,475,510,496,421,308,351,227,309,5705,5821,6068
E02002434,"Robin Hood, Lofthouse & Middleton Lane",549,266,694,674,886,896,869,779,760,668,493,331,334,223,276,7883,8149,8698
E02002435,Morley Bruntcliffe & Woodkirk,405,188,570,578,660,728,600,601,646,557,489,389,410,293,357,6878,7066,7471
E02002436,Tingley East & East Ardsley,359,162,499,481,508,496,451,456,538,557,464,339,326,269,300,5684,5846,6205
E02002437,Tingley West & West Ardsley,332,150,473,338,367,400,420,442,590,563,512,392,355,207,268,5327,5477,5809
E02006852,Far Headingley & Weetwood,411,192,2133,1528,1180,1026,953,704,632,649,544,517,493,330,451,11140,11332,11743
E02006861,Hyde Park Corner & Woodhouse Cliff,152,76,7734,1950,1201,887,596,381,317,241,182,172,145,96,268,14170,14246,14398
E02006875,Leeds City Centre,55,98,7772,3374,1725,1063,587,272,219,159,106,55,34,16,11,15393,15491,15546
E02006876,"Leeds Dock, Hunslet & Stourton",298,129,1202,1270,1179,1014,661,458,373,363,292,236,222,143,231,7644,7773,8071
E02002438,Ferry Fryston,512,235,686,701,782,698,516,477,659,605,484,431,377,252,301,6969,7204,7716
E02002439,Castleford Town,375,180,653,744,839,687,548,642,731,687,579,402,441,294,382,7629,7809,8184
E02002440,Airedale,443,202,617,500,568,533,451,535,639,605,543,423,432,298,363,6507,6709,7152
E02002441,Castleford West,487,218,769,744,788,717,613,696,771,656,554,396,439,387,428,7958,8176,8663
E02002442,Glasshoughton,302,143,476,540,616,522,418,484,649,630,486,385,332,258,277,6073,6216,6518
E02002443,Outwood East,274,114,447,387,442,459,412,411,537,433,521,348,310,230,191,5128,5242,5516
E02002444,"Stanley, Moorhouse & Bottomboat",313,132,407,517,587,532,473,467,521,510,426,394,329,261,249,5673,5805,6118
E02002445,Outwood West,402,169,587,520,601,662,559,577,623,637,499,403,503,356,487,7014,7183,7585
E02002446,Altofts,238,119,401,386,404,398,291,365,501,533,468,374,385,305,358,5169,5288,5526
E02002447,Knottingley,297,126,440,405,504,404,380,388,471,475,397,335,329,226,347,5101,5227,5524
E02002448,Ferrybridge & West Knottingley,413,182,613,669,690,581,460,459,562,651,486,414,394,270,355,6604,6786,7199
E02002449,Pontefract North East,442,230,616,768,849,716,560,647,783,745,556,431,438,339,418,7866,8096,8538
E02002450,Normanton East,360,175,570,569,652,590,506,570,684,597,441,405,399,243,294,6520,6695,7055
E02002451,Wrenthorpe & Kirkhamgate,319,158,510,408,506,508,468,518,644,600,567,527,534,411,451,6652,6810,7129
E02002452,Pontefract North West,362,177,668,710,764,719,610,602,690,627,520,435,422,282,409,7458,7635,7997
E02002453,Normanton West,483,228,803,859,923,830,710,670,822,718,659,508,498,328,371,8699,8927,9410
E02002454,Wakefield Central,481,221,975,1052,1182,1119,962,779,700,623,489,357,324,174,354,9090,9311,9792
E02002455,Pontefract South East,426,191,517,458,474,479,395,404,497,486,400,300,309,201,261,5181,5372,5798
E02002456,Wakefield St John's,367,174,708,783,869,817,729,593,600,553,450,337,318,224,212,7193,7367,7734
E02002457,Eastmoor,496,201,713,603,694,748,688,575,589,572,452,407,358,231,296,6926,7127,7623
E02002458,Ossett North,399,210,608,531,592,576,564,646,712,626,543,486,568,392,454,7298,7508,7907
E02002459,Alverthorpe & Flanshaw,562,257,869,791,819,831,717,744,812,737,575,417,397,275,358,8342,8599,9161
E02002460,Pontefract South West,316,174,472,359,435,447,446,482,577,576,537,515,517,377,588,6328,6502,6818
E02002461,Streethouse & Sharlston Common,553,265,867,839,922,915,799,776,924,812,704,531,514,412,471,9486,9751,10304
E02002462,Ossett West,354,188,508,439,410,491,489,557,628,562,484,460,483,353,400,6264,6452,6806
E02002463,Lupset,662,317,889,736,876,869,749,658,758,650,455,381,355,275,362,8013,8330,8992
E02002464,Featherstone,410,189,683,747,829,675,548,561,641,662,558,443,422,325,371,7465,7654,8064
E02002465,Thornes,217,98,444,446,454,418,416,383,482,533,467,410,396,344,403,5596,5694,5911
E02002466,Ossett South East & Horbury Bridge,435,209,604,495,583,597,628,599,694,712,591,553,597,478,522,7653,7862,8297
E02002467,Agbrigg & Belle Isle,498,239,935,967,1014,950,787,662,669,599,463,350,313,178,207,8094,8333,8831
E02002468,Horbury,303,131,398,339,383,370,383,460,502,477,410,363,424,276,324,5109,5240,5543
E02002469,Crofton,300,146,447,419,434,453,379,431,532,554,443,386,423,323,275,5499,5645,5945
E02002470,Sandal,257,121,349,222,307,313,348,375,485,478,468,440,528,456,576,5345,5466,5723
E02002471,Ackworth & Darrington,541,263,699,637,742,745,686,767,869,928,841,756,727,570,649,9616,9879,10420
E02002472,Netherton & Middlestown,252,126,430,343,401,396,358,433,541,453,457,420,404,291,318,5245,5371,5623
E02002473,Durkar & Crigglestone,255,122,471,458,442,415,389,431,525,513,529,504,418,332,363,5790,5912,6167
E02002474,Kettlethorpe & Chapelthorpe,325,166,498,461,520,577,465,436,530,526,421,344,344,234,270,5626,5792,6117
E02002475,"Walton, Woolley & Bretton",258,130,336,276,317,358,401,395,506,527,446,453,488,366,453,5322,5452,5710
E02002476,Kinsley & Fitzwilliam,343,144,552,577,578,505,381,414,506,440,405,301,267,210,241,5377,5521,5864
E02002477,Ryhill & South Hiendley,337,152,463,412,440,421,355,425,493,484,436,375,369,239,288,5200,5352,5689
E02002478,Upton,339,145,497,450,503,482,393,357,511,497,430,307,277,215,210,5129,5274,5613
E02002479,Hemsworth Town,389,175,620,503,592,535,505,458,626,660,632,534,485,451,436,7037,7212,7601
E02002480,Moorthorpe,204,118,477,435,452,448,376,345,470,398,406,404,323,289,319,5142,5260,5464
E02002481,South Elmsall,369,185,605,504,595,603,486,460,597,539,470,405,320,229,356,6169,6354,6723
E02002482,South Kirkby,443,209,563,512,600,556,469,458,519,460,430,359,312,233,283,5754,5963,6406
